,Opp,Tm,Opp.1,1stD,TotYd,PassY,RushY,TO,1stD.1,TotYd.1,PassY.1,RushY.1,TO.1,Offense,Defense,Sp. Tms,Home_team,Year,Winner
0,Tampa Bay Buccaneers,31,17,17,256,158,98,2,21,295,174,121,4,-7.51,19.12,1.1,San Francisco 49ers,2019,San Francisco 49ers
1,Cincinnati Bengals,41,17,27,571,312,259,1,14,316,291,25,1,27.34,1.14,-6.64,San Francisco 49ers,2019,San Francisco 49ers
2,Pittsburgh Steelers,24,20,26,436,268,168,5,11,239,160,79,2,-3.72,10.2,0.12,San Francisco 49ers,2019,San Francisco 49ers
3,Los Angeles Rams,20,7,22,331,232,99,2,10,157,48,109,1,-3.54,25.23,-5.01,San Francisco 49ers,2019,San Francisco 49ers
4,Washington Redskins,9,0,17,283,146,137,1,10,154,50,104,1,-1.99,14.12,-0.61,San Francisco 49ers,2019,San Francisco 49ers
5,Carolina Panthers,51,13,24,388,156,232,1,12,230,100,130,3,15.84,30.05,-7.14,San Francisco 49ers,2019,San Francisco 49ers
6,Seattle Seahawks,24,27,21,302,215,87,3,19,336,189,147,4,-17.73,17.69,-4.23,San Francisco 49ers,2019,Seattle Seahawks
7,Arizona Cardinals,36,26,26,442,408,34,2,21,266,131,135,2,8.92,-0.09,1.17,San Francisco 49ers,2019,San Francisco 49ers
8,Baltimore Ravens,17,20,15,331,157,174,1,21,283,105,178,1,6.2,-6.4,-1.2,San Francisco 49ers,2019,Baltimore Ravens
9,New Orleans Saints,48,46,25,516,354,162,1,28,465,349,116,1,27.42,-21.97,-3.51,San Francisco 49ers,2019,San Francisco 49ers
10,Atlanta Falcons,22,29,20,313,193,120,2,20,290,201,89,1,2.84,-7.04,-2.73,San Francisco 49ers,2019,Atlanta Falcons
11,Los Angeles Rams,34,31,19,334,215,119,2,24,395,323,72,1,3.67,-3.16,1.84,San Francisco 49ers,2019,San Francisco 49ers
12,Minnesota Vikings,27,10,21,308,122,186,2,7,147,126,21,2,0.66,16.91,-0.78,San Francisco 49ers,2019,San Francisco 49ers
13,Kansas City Chiefs,20,31,21,351,210,141,2,26,397,268,129,2,5.19,-18.54,1.58,San Francisco 49ers,2019,Kansas City Chiefs
14,Washington Redskins,31,15,21,298,208,90,1,25,356,287,69,5,9.23,11.86,-3.52,Chicago Bears,2019,Chicago Bears
15,Oakland Raiders,21,24,15,236,194,42,2,25,398,229,169,2,-3.03,-2.24,-0.43,Chicago Bears,2019,Oakland Raiders
16,Los Angeles Chargers,16,17,26,388,226,162,2,11,231,195,36,1,0.44,5.45,-6.02,Chicago Bears,2019,Los Angeles Chargers
17,Los Angeles Rams,7,17,17,267,193,74,1,13,283,173,110,2,-13.17,5.69,-5.08,Chicago Bears,2019,Los Angeles Rams
18,New York Giants,19,14,20,335,270,65,2,14,243,134,109,1,-7.02,12.48,-2.01,Chicago Bears,2019,Chicago Bears
19,Detroit Lions,24,20,22,419,331,88,1,19,364,259,105,1,8.33,-6.28,0.13,Chicago Bears,2019,Chicago Bears
20,Minnesota Vikings,21,19,24,337,179,158,1,14,300,126,174,3,1.26,-2.15,-1.08,Chicago Bears,2019,Chicago Bears
21,Seattle Seahawks,20,21,22,429,395,34,3,12,232,160,72,1,0.16,5.43,-8.5,Cincinnati Bengals,2019,Seattle Seahawks
22,San Francisco 49ers,17,41,14,316,291,25,1,27,571,312,259,1,-1.14,-27.34,6.64,Cincinnati Bengals,2019,San Francisco 49ers
23,Buffalo Bills,17,21,17,306,240,66,4,25,416,241,175,2,-9.17,-1.8,8.04,Cincinnati Bengals,2019,Buffalo Bills
24,Pittsburgh Steelers,3,27,16,175,102,73,2,20,326,260,66,1,-16.54,-6.93,0.04,Cincinnati Bengals,2019,Pittsburgh Steelers
25,Baltimore Ravens,17,23,18,250,217,33,1,26,497,228,269,1,0.57,-15.13,4.92,Cincinnati Bengals,2019,Baltimore Ravens
26,Baltimore Ravens,13,49,21,307,150,157,3,20,379,243,136,1,-18.52,-24.79,7.48,Cincinnati Bengals,2019,Baltimore Ravens
27,Oakland Raiders,10,17,16,246,73,173,2,20,386,273,113,2,-9.64,-3.46,3.29,Cincinnati Bengals,2019,Oakland Raiders
28,Pittsburgh Steelers,10,16,11,244,158,86,2,16,338,179,159,1,-15.56,4.31,2.52,Cincinnati Bengals,2019,Pittsburgh Steelers
29,Cleveland Browns,19,27,27,451,272,179,1,17,333,187,146,2,1.25,-6.12,-5.82,Cincinnati Bengals,2019,Cleveland Browns
30,Miami Dolphins,35,38,25,430,371,59,1,29,502,406,96,1,7.22,-21.63,8.48,Cincinnati Bengals,2019,Miami Dolphins
31,Cleveland Browns,33,23,22,361,182,179,1,15,313,239,74,3,12.26,-1.53,-3.69,Cincinnati Bengals,2019,Cincinnati Bengals
32,Los Angeles Chargers,20,13,15,350,159,191,2,19,246,211,35,3,-2.29,12.18,-0.78,Denver Broncos,2019,Denver Broncos
33,Tennessee Titans,16,0,11,270,167,103,1,12,204,165,39,3,-10.82,25.18,1.34,Denver Broncos,2019,Denver Broncos
34,Minnesota Vikings,23,27,20,394,270,124,1,19,321,284,37,2,4.61,-8.51,2.33,Denver Broncos,2019,Minnesota Vikings
35,Buffalo Bills,3,20,9,134,49,85,1,22,424,180,244,1,-14.64,-8.5,3.59,Denver Broncos,2019,Buffalo Bills
36,Los Angeles Chargers,23,20,13,218,134,84,1,17,359,244,115,2,-2.73,-1.4,11.44,Denver Broncos,2019,Denver Broncos
37,Houston Texans,38,24,22,391,301,90,1,26,414,280,134,3,18.37,-1.1,-3.75,Denver Broncos,2019,Denver Broncos
38,Kansas City Chiefs,3,23,15,251,199,52,1,27,419,327,92,1,-9.67,-15.31,4.87,Denver Broncos,2019,Kansas City Chiefs
39,Oakland Raiders,16,15,16,238,168,70,1,18,477,380,97,1,-8.2,0.3,10.2,Denver Broncos,2019,Denver Broncos
40,New York Jets,23,3,16,375,305,70,1,13,262,169,93,1,4.95,14.42,-0.9,Cleveland Browns,2019,Cleveland Browns
41,Los Angeles Rams,13,20,18,270,175,95,1,20,344,254,90,3,-8.89,-1.06,3.41,Cleveland Browns,2019,Los Angeles Rams
42,Baltimore Ravens,40,25,22,530,337,193,1,24,395,222,173,3,23.04,-4.82,-3.35,Cleveland Browns,2019,Cleveland Browns
43,Seattle Seahawks,28,32,21,406,249,157,4,29,454,284,170,1,3.24,-15.53,4.92,Cleveland Browns,2019,Seattle Seahawks
44,Miami Dolphins,41,24,30,467,320,147,1,22,284,192,92,2,26.93,-5.91,-3.5,Cleveland Browns,2019,Cleveland Browns
45,Pittsburgh Steelers,13,20,19,279,173,106,2,18,323,199,124,1,-2.6,-2.57,-1.39,Cleveland Browns,2019,Pittsburgh Steelers
46,Cincinnati Bengals,27,19,17,333,187,146,2,27,451,272,179,1,6.12,-1.25,5.82,Cleveland Browns,2019,Cleveland Browns
47,Arizona Cardinals,24,38,25,393,241,152,2,26,445,219,226,1,10.72,-24.27,-1.61,Cleveland Browns,2019,Arizona Cardinals
48,Baltimore Ravens,15,31,17,241,184,57,1,31,481,238,243,1,-0.38,-21.45,4.46,Cleveland Browns,2019,Baltimore Ravens
49,Cincinnati Bengals,23,33,15,313,239,74,3,22,361,182,179,1,1.53,-12.26,3.69,Cleveland Browns,2019,Cincinnati Bengals
50,San Francisco 49ers,17,31,21,295,174,121,4,17,256,158,98,2,-19.12,7.51,-1.1,Tampa Bay Buccaneers,2019,San Francisco 49ers
51,New York Giants,31,32,24,499,355,144,1,17,384,312,72,2,14.58,-8.02,-6.08,Tampa Bay Buccaneers,2019,New York Giants
52,Los Angeles Rams,55,40,27,464,376,88,1,36,518,490,28,4,22.76,-4.47,-4.04,Tampa Bay Buccaneers,2019,Tampa Bay Buccaneers
53,Carolina Panthers,26,37,23,407,365,42,7,17,268,209,59,1,-14.39,2.76,0.09,Tampa Bay Buccaneers,2019,Carolina Panthers
54,Tennessee Titans,23,27,23,389,283,106,4,16,246,174,72,1,-6.92,2.72,-1.66,Tampa Bay Buccaneers,2019,Tennessee Titans
55,Seattle Seahawks,34,40,29,418,319,99,1,31,492,347,145,1,13.19,-23.58,6.92,Tampa Bay Buccaneers,2019,Seattle Seahawks
56,Arizona Cardinals,30,27,26,457,339,118,3,20,417,342,75,2,9.52,-1.71,-3.53,Tampa Bay Buccaneers,2019,Tampa Bay Buccaneers
57,Atlanta Falcons,35,22,20,446,313,133,2,22,337,280,57,2,11.9,5.6,-3.77,Tampa Bay Buccaneers,2019,Tampa Bay Buccaneers
58,Jacksonville Jaguars,28,11,19,315,241,74,1,14,242,193,49,4,-4.31,26.93,-2.93,Tampa Bay Buccaneers,2019,Tampa Bay Buccaneers
59,Indianapolis Colts,38,35,29,542,467,75,4,16,309,243,66,1,9.53,-8.36,3.36,Tampa Bay Buccaneers,2019,Tampa Bay Buccaneers
60,Detroit Lions,38,17,23,495,446,49,1,16,295,250,45,3,13.82,14.38,-7.29,Tampa Bay Buccaneers,2019,Tampa Bay Buccaneers
61,Houston Texans,20,23,19,435,329,106,5,15,229,161,68,2,-8.4,13.02,-7.92,Tampa Bay Buccaneers,2019,Houston Texans
62,Atlanta Falcons,22,28,14,329,193,136,3,28,373,286,87,1,-5.96,8.27,-9.46,Tampa Bay Buccaneers,2019,Atlanta Falcons
63,New York Jets,17,16,23,370,242,128,4,17,223,155,68,1,-3.17,7.39,-1.63,Buffalo Bills,2019,Buffalo Bills
64,Cincinnati Bengals,21,17,25,416,241,175,2,17,306,240,66,4,1.8,9.17,-8.04,Buffalo Bills,2019,Buffalo Bills
65,New England Patriots,10,16,23,375,240,135,4,11,224,150,74,1,-12.71,14.59,-6.09,Buffalo Bills,2019,New England Patriots
66,Philadelphia Eagles,13,31,16,253,155,98,1,21,371,153,218,1,-7.91,-10.88,5.78,Buffalo Bills,2019,Philadelphia Eagles
67,Denver Broncos,20,3,22,424,180,244,1,9,134,49,85,1,8.5,14.64,-3.59,Buffalo Bills,2019,Buffalo Bills
68,Baltimore Ravens,17,24,16,209,105,104,1,18,257,139,118,1,-10.78,0.75,2.47,Buffalo Bills,2019,Baltimore Ravens
69,Pittsburgh Steelers,17,10,17,261,131,130,2,15,229,178,51,5,-6.56,17.22,-3.78,Buffalo Bills,2019,Buffalo Bills
70,New York Jets,6,13,17,309,236,73,3,18,271,185,86,1,-13.72,3.92,1.1,Buffalo Bills,2019,New York Jets
71,Houston Texans,19,22,24,425,253,172,1,19,360,219,141,1,-1.04,-2.61,1.38,Buffalo Bills,2019,Houston Texans
72,Detroit Lions,27,27,21,387,275,112,1,23,477,361,116,2,-3.5,-7.02,9.8,Arizona Cardinals,2019,None
73,Carolina Panthers,20,38,21,248,127,121,2,21,413,240,173,1,-3.15,-19.08,3.46,Arizona Cardinals,2019,Carolina Panthers
74,Tampa Bay Buccaneers,27,30,20,417,342,75,2,26,457,339,118,3,1.71,-9.52,3.53,Arizona Cardinals,2019,Tampa Bay Buccaneers
75,San Francisco 49ers,26,36,21,266,131,135,2,26,442,408,34,2,0.09,-8.92,-1.17,Arizona Cardinals,2019,San Francisco 49ers
76,Pittsburgh Steelers,17,23,17,236,165,71,3,20,275,135,140,2,-5.35,-5.34,2.85,Arizona Cardinals,2019,Pittsburgh Steelers
77,Cleveland Browns,38,24,26,445,219,226,1,25,393,241,152,2,24.27,-10.72,1.61,Arizona Cardinals,2019,Arizona Cardinals
78,Detroit Lions,10,13,21,424,287,137,2,19,339,245,94,2,5.86,-8.62,-0.56,Los Angeles Chargers,2019,Detroit Lions
79,Houston Texans,20,27,22,366,293,73,1,20,376,337,39,1,6.08,-16.39,1.94,Los Angeles Chargers,2019,Houston Texans
80,Denver Broncos,13,20,19,246,211,35,3,15,350,159,191,2,-12.18,2.29,0.78,Los Angeles Chargers,2019,Denver Broncos
81,Pittsburgh Steelers,17,24,23,348,316,32,3,18,256,132,124,1,-2.12,-5.45,-4.54,Los Angeles Chargers,2019,Pittsburgh Steelers
82,Tennessee Titans,20,23,24,365,326,39,1,22,403,306,97,1,8.93,-10.83,-0.57,Los Angeles Chargers,2019,Tennessee Titans
83,Chicago Bears,17,16,11,231,195,36,1,26,388,226,162,2,-5.45,-0.44,6.02,Los Angeles Chargers,2019,Los Angeles Chargers
84,Kansas City Chiefs,17,24,23,438,345,93,4,18,310,180,130,1,-1.36,-4.13,-2.05,Los Angeles Chargers,2019,Kansas City Chiefs
85,Denver Broncos,20,23,17,359,244,115,2,13,218,134,84,1,1.4,2.73,-11.44,Los Angeles Chargers,2019,Denver Broncos
86,Minnesota Vikings,10,39,17,345,283,62,7,18,344,207,137,1,-20.63,-5.27,0.79,Los Angeles Chargers,2019,Minnesota Vikings
87,Kansas City Chiefs,21,31,25,366,258,108,2,16,336,174,162,1,9.18,-13.59,-7.29,Los Angeles Chargers,2019,Kansas City Chiefs
88,Oakland Raiders,28,10,24,467,436,31,1,19,307,178,129,2,18.12,2.14,-2.97,Kansas City Chiefs,2019,Kansas City Chiefs
89,Detroit Lions,34,30,29,438,315,123,3,29,447,261,186,2,17.08,-1.27,-13.41,Kansas City Chiefs,2019,Kansas City Chiefs
90,Indianapolis Colts,13,19,18,324,288,36,1,25,331,151,180,1,-1.57,-4.31,-1.09,Kansas City Chiefs,2019,Indianapolis Colts
91,Houston Texans,24,31,20,309,256,53,2,35,472,280,192,3,6.1,-16.92,1.87,Kansas City Chiefs,2019,Houston Texans
92,Tennessee Titans,32,35,28,530,433,97,1,19,371,146,225,1,13.98,-11.07,-3.81,Kansas City Chiefs,2019,Tennessee Titans
93,Los Angeles Chargers,24,17,18,310,180,130,1,23,438,345,93,4,4.13,1.36,2.05,Kansas City Chiefs,2019,Kansas City Chiefs
94,New England Patriots,23,16,20,346,271,75,2,17,278,184,94,1,-1.14,5.79,1.25,Kansas City Chiefs,2019,Kansas City Chiefs
95,Denver Broncos,23,3,27,419,327,92,1,15,251,199,52,1,15.31,9.67,-4.87,Kansas City Chiefs,2019,Kansas City Chiefs
96,Los Angeles Chargers,31,21,16,336,174,162,1,25,366,258,108,2,13.59,-9.18,7.29,Kansas City Chiefs,2019,Kansas City Chiefs
97,Houston Texans,51,31,29,434,316,118,1,23,442,348,94,1,28.73,-5.46,-6.77,Kansas City Chiefs,2019,Kansas City Chiefs
98,San Francisco 49ers,31,20,26,397,268,129,2,21,351,210,141,2,18.54,-5.19,-1.58,Kansas City Chiefs,2019,Kansas City Chiefs
99,Oakland Raiders,24,31,22,346,265,81,2,21,377,189,188,1,1.6,-8.99,-0.78,Indianapolis Colts,2019,Oakland Raiders
100,Kansas City Chiefs,19,13,25,331,151,180,1,18,324,288,36,1,4.31,1.57,1.09,Indianapolis Colts,2019,Indianapolis Colts
101,Houston Texans,30,23,23,383,321,62,1,21,391,291,100,2,8.42,-1.33,0.23,Indianapolis Colts,2019,Indianapolis Colts
102,Pittsburgh Steelers,24,26,22,328,189,139,3,17,273,183,90,2,-0.41,3.46,-5.69,Indianapolis Colts,2019,Pittsburgh Steelers
103,Miami Dolphins,12,16,19,300,191,109,3,13,229,159,70,2,-16.98,16.73,-3.1,Indianapolis Colts,2019,Miami Dolphins
104,Jacksonville Jaguars,33,13,23,389,125,264,2,15,308,279,29,1,15.77,4.19,-5.81,Indianapolis Colts,2019,Indianapolis Colts
105,Tennessee Titans,17,31,22,391,309,82,3,15,292,138,154,2,-1.63,1.94,-12.84,Indianapolis Colts,2019,Tennessee Titans
106,Tampa Bay Buccaneers,35,38,16,309,243,66,1,29,542,467,75,4,8.36,-9.53,-3.36,Indianapolis Colts,2019,Tampa Bay Buccaneers
107,Jacksonville Jaguars,20,38,17,275,143,132,2,23,353,286,67,1,-5.69,-13.7,-0.18,Indianapolis Colts,2019,Jacksonville Jaguars
108,Miami Dolphins,31,6,28,476,241,235,1,17,283,211,72,1,19.62,14,-6.19,Dallas Cowboys,2019,Dallas Cowboys
109,New Orleans Saints,10,12,15,257,212,45,3,18,266,149,117,1,1.46,1.84,-0.65,Dallas Cowboys,2019,New Orleans Saints
110,Philadelphia Eagles,37,10,23,402,213,189,1,16,283,168,115,4,15.32,10.92,-0.53,Dallas Cowboys,2019,Dallas Cowboys
111,New York Giants,37,18,24,429,257,172,2,20,271,171,100,3,10.68,12.66,-5.61,Dallas Cowboys,2019,Dallas Cowboys
112,Washington Redskins,47,16,22,517,294,223,1,13,271,183,88,2,17.75,18.31,-5.03,Dallas Cowboys,2019,Dallas Cowboys
113,New England Patriots,0,43,11,184,142,42,4,27,379,255,124,1,-35.44,-14.12,12.05,Miami Dolphins,2019,New England Patriots
114,Dallas Cowboys,6,31,17,283,211,72,1,28,476,241,235,1,-14,-19.62,6.19,Miami Dolphins,2019,Dallas Cowboys
115,Pittsburgh Steelers,14,27,16,230,170,60,4,21,394,236,158,1,-12.16,-5.58,3.84,Miami Dolphins,2019,Pittsburgh Steelers
116,Indianapolis Colts,16,12,13,229,159,70,2,19,300,191,109,3,-16.73,16.98,3.1,Miami Dolphins,2019,Miami Dolphins
117,Cleveland Browns,24,41,22,284,192,92,2,30,467,320,147,1,5.91,-26.93,3.5,Miami Dolphins,2019,Cleveland Browns
118,Philadelphia Eagles,37,31,26,409,351,58,1,23,386,294,92,1,16.93,-11.33,-0.08,Miami Dolphins,2019,Miami Dolphins
119,New York Jets,21,22,22,362,240,122,1,22,374,262,112,1,5.46,-5.93,-0.46,Miami Dolphins,2019,New York Jets
120,New York Giants,20,36,22,384,262,122,1,24,412,274,138,3,0.43,-13.11,-4.97,Miami Dolphins,2019,New York Giants
121,Cincinnati Bengals,38,35,29,502,406,96,1,25,430,371,59,1,21.63,-7.22,-8.48,Miami Dolphins,2019,Miami Dolphins
122,Atlanta Falcons,20,24,18,286,237,49,3,19,367,310,57,3,-5.22,-3.96,4.03,Philadelphia Eagles,2019,Atlanta Falcons
123,New York Jets,31,6,17,265,181,84,1,9,128,61,67,3,-4.56,35.65,-6.44,Philadelphia Eagles,2019,Philadelphia Eagles
124,Minnesota Vikings,20,38,19,400,292,108,3,26,447,325,122,2,2.18,-17.04,0.52,Philadelphia Eagles,2019,Minnesota Vikings
125,Dallas Cowboys,10,37,16,283,168,115,4,23,402,213,189,1,-10.92,-15.32,0.53,Philadelphia Eagles,2019,Dallas Cowboys
126,Buffalo Bills,31,13,21,371,153,218,1,16,253,155,98,1,10.88,7.91,-5.78,Philadelphia Eagles,2019,Philadelphia Eagles
127,Seattle Seahawks,9,17,23,344,238,106,5,14,348,174,174,2,-17.25,4.38,0.2,Philadelphia Eagles,2019,Seattle Seahawks
128,Miami Dolphins,31,37,23,386,294,92,1,26,409,351,58,1,11.33,-16.93,0.08,Philadelphia Eagles,2019,Miami Dolphins
129,Washington Redskins,37,27,27,415,258,157,1,19,352,251,101,1,19.99,-5.52,-3.89,Philadelphia Eagles,2019,Philadelphia Eagles
130,Philadelphia Eagles,24,20,19,367,310,57,3,18,286,237,49,3,3.96,5.22,-4.03,Atlanta Falcons,2019,Atlanta Falcons
131,Houston Texans,32,53,22,373,316,57,1,31,592,426,166,1,6.4,-40.69,9.43,Atlanta Falcons,2019,Houston Texans
132,Tampa Bay Buccaneers,22,35,22,337,280,57,2,20,446,313,133,2,-5.6,-11.9,3.77,Atlanta Falcons,2019,Tampa Bay Buccaneers
133,San Francisco 49ers,29,22,20,290,201,89,1,20,313,193,120,2,7.04,-2.84,2.73,Atlanta Falcons,2019,Atlanta Falcons
134,Jacksonville Jaguars,24,12,28,518,383,135,2,17,288,173,115,1,18.86,4.26,-7.84,Atlanta Falcons,2019,Atlanta Falcons
135,Tampa Bay Buccaneers,28,22,28,373,286,87,1,14,329,193,136,3,-8.27,5.96,9.46,Atlanta Falcons,2019,Atlanta Falcons
136,Tampa Bay Buccaneers,32,31,17,384,312,72,2,24,499,355,144,1,8.02,-14.58,6.08,New York Giants,2019,New York Giants
137,Washington Redskins,24,3,24,389,225,164,4,8,176,121,55,4,0.43,25.74,-4.64,New York Giants,2019,New York Giants
138,Minnesota Vikings,10,28,18,211,147,64,1,22,490,279,211,1,-8.73,-16.93,0.4,New York Giants,2019,Minnesota Vikings
139,New England Patriots,14,35,10,213,161,52,4,27,427,313,114,2,-24.29,0.69,-1.1,New York Giants,2019,New England Patriots
140,Detroit Lions,26,31,24,370,290,80,1,17,375,316,59,2,6.34,-7.67,-5.39,New York Giants,2019,Detroit Lions
141,Dallas Cowboys,18,37,20,271,171,100,3,24,429,257,172,2,-12.66,-10.68,5.61,New York Giants,2019,Dallas Cowboys
142,Chicago Bears,14,19,14,243,134,109,1,20,335,270,65,2,-12.48,7.02,2.01,New York Giants,2019,Chicago Bears
143,Miami Dolphins,36,20,24,412,274,138,3,22,384,262,122,1,13.11,-0.43,4.97,New York Giants,2019,New York Giants
144,New York Jets,29,15,21,389,278,111,1,15,213,167,46,3,4.35,12.91,-3.33,Jacksonville Jaguars,2019,Jacksonville Jaguars
145,Houston Texans,3,26,21,356,282,74,4,21,410,194,216,1,-12.02,-8.05,0.32,Jacksonville Jaguars,2019,Houston Texans
146,Indianapolis Colts,13,33,15,308,279,29,1,23,389,125,264,2,-4.19,-15.77,5.81,Jacksonville Jaguars,2019,Indianapolis Colts
147,Tennessee Titans,20,42,23,369,252,117,1,21,471,252,219,2,1.2,-20.75,-2.59,Jacksonville Jaguars,2019,Tennessee Titans
148,Tampa Bay Buccaneers,11,28,14,242,193,49,4,19,315,241,74,1,-26.93,4.31,2.93,Jacksonville Jaguars,2019,Tampa Bay Buccaneers
149,Atlanta Falcons,12,24,17,288,173,115,1,28,518,383,135,2,-4.26,-18.86,7.84,Jacksonville Jaguars,2019,Atlanta Falcons
150,Indianapolis Colts,38,20,23,353,286,67,1,17,275,143,132,2,13.7,5.69,0.18,Jacksonville Jaguars,2019,Jacksonville Jaguars
151,Buffalo Bills,16,17,17,223,155,68,1,23,370,242,128,4,-7.39,3.17,1.63,New York Jets,2019,Buffalo Bills
152,Cleveland Browns,3,23,13,262,169,93,1,16,375,305,70,1,-14.42,-4.95,0.9,New York Jets,2019,Cleveland Browns
153,New England Patriots,14,30,6,105,69,36,1,21,381,313,68,2,-26.43,-1.65,9.81,New York Jets,2019,New England Patriots
154,Philadelphia Eagles,6,31,9,128,61,67,3,17,265,181,84,1,-35.65,4.56,6.44,New York Jets,2019,Philadelphia Eagles
155,New England Patriots,0,33,12,154,73,81,6,22,323,249,74,1,-28.37,-2.21,-1.82,New York Jets,2019,New England Patriots
156,Jacksonville Jaguars,15,29,15,213,167,46,3,21,389,278,111,1,-12.91,-4.35,3.33,New York Jets,2019,Jacksonville Jaguars
157,Washington Redskins,34,17,23,400,285,115,2,13,225,171,54,1,10.08,18.32,-9.2,New York Jets,2019,New York Jets
158,Oakland Raiders,34,3,21,401,313,88,1,10,208,140,68,2,12.75,19.86,-2.36,New York Jets,2019,New York Jets
159,Miami Dolphins,22,21,22,374,262,112,1,22,362,240,122,1,5.93,-5.46,0.46,New York Jets,2019,New York Jets
160,Pittsburgh Steelers,16,10,14,259,174,85,1,16,260,185,75,2,-8.44,11.79,5.1,New York Jets,2019,New York Jets
161,Buffalo Bills,13,6,18,271,185,86,1,17,309,236,73,3,-3.92,13.72,-1.1,New York Jets,2019,New York Jets
162,Arizona Cardinals,27,27,23,477,361,116,2,21,387,275,112,1,7.02,3.5,-9.8,Detroit Lions,2019,None
163,Los Angeles Chargers,13,10,19,339,245,94,2,21,424,287,137,2,8.62,-5.86,0.56,Detroit Lions,2019,Detroit Lions
164,Kansas City Chiefs,30,34,29,447,261,186,2,29,438,315,123,3,1.27,-17.08,13.41,Detroit Lions,2019,Kansas City Chiefs
165,New York Giants,31,26,17,375,316,59,2,24,370,290,80,1,7.67,-6.34,5.39,Detroit Lions,2019,Detroit Lions
166,Washington Redskins,16,19,21,364,189,175,4,13,230,144,86,2,-8.85,13.57,-10.88,Detroit Lions,2019,Washington Redskins
167,Chicago Bears,20,24,19,364,259,105,1,22,419,331,88,1,6.28,-8.33,-0.13,Detroit Lions,2019,Chicago Bears
168,Tampa Bay Buccaneers,17,38,16,295,250,45,3,23,495,446,49,1,-14.38,-13.82,7.29,Detroit Lions,2019,Tampa Bay Buccaneers
169,Green Bay Packers,20,23,17,305,134,171,1,25,432,312,120,1,1.53,-8.54,4.01,Detroit Lions,2019,Green Bay Packers
170,Minnesota Vikings,21,16,20,335,191,144,2,15,421,223,198,4,-7.02,6.94,5.3,Green Bay Packers,2019,Green Bay Packers
171,Washington Redskins,20,15,18,341,167,174,1,18,262,141,121,1,5.07,1.04,0.91,Green Bay Packers,2019,Green Bay Packers
172,Minnesota Vikings,23,10,22,383,199,184,3,7,139,82,57,1,-5.18,25.86,-6.94,Green Bay Packers,2019,Green Bay Packers
173,Detroit Lions,23,20,25,432,312,120,1,17,305,134,171,1,8.54,-1.53,-4.01,Green Bay Packers,2019,Green Bay Packers
174,Los Angeles Rams,27,30,21,343,216,127,3,22,349,183,166,1,-3.24,-4.57,3.39,Carolina Panthers,2019,Los Angeles Rams
175,Arizona Cardinals,38,20,21,413,240,173,1,21,248,127,121,2,19.08,3.15,-3.46,Carolina Panthers,2019,Carolina Panthers
176,Houston Texans,16,10,19,297,203,94,3,18,264,128,136,2,-5.69,9.25,-1.44,Carolina Panthers,2019,Carolina Panthers
177,Tampa Bay Buccaneers,37,26,17,268,209,59,1,23,407,365,42,7,-2.76,14.39,-0.09,Carolina Panthers,2019,Carolina Panthers
178,San Francisco 49ers,13,51,12,230,100,130,3,24,388,156,232,1,-30.05,-15.84,7.14,Carolina Panthers,2019,San Francisco 49ers
179,Tennessee Titans,30,20,22,370,214,156,1,24,431,310,121,3,9.15,-5.05,4.67,Carolina Panthers,2019,Carolina Panthers
180,New Orleans Saints,31,34,26,351,230,121,1,23,418,300,118,1,16.55,-15.06,-5.89,Carolina Panthers,2019,New Orleans Saints
181,Seattle Seahawks,24,30,28,414,269,145,3,21,428,274,154,1,6.32,-16.22,3.89,Carolina Panthers,2019,Seattle Seahawks
182,Miami Dolphins,43,0,27,379,255,124,1,11,184,142,42,4,14.12,35.44,-12.05,New England Patriots,2019,New England Patriots
183,New York Jets,30,14,21,381,313,68,2,6,105,69,36,1,1.65,26.43,-9.81,New England Patriots,2019,New England Patriots
184,Buffalo Bills,16,10,11,224,150,74,1,23,375,240,135,4,-14.59,12.71,6.09,New England Patriots,2019,New England Patriots
185,Washington Redskins,33,7,23,442,312,130,1,11,223,78,145,2,9.23,20.78,-6.54,New England Patriots,2019,New England Patriots
186,New York Giants,35,14,27,427,313,114,2,10,213,161,52,4,-0.69,24.29,1.1,New England Patriots,2019,New England Patriots
187,New York Jets,33,0,22,323,249,74,1,12,154,73,81,6,2.21,28.37,1.82,New England Patriots,2019,New England Patriots
188,Baltimore Ravens,20,37,22,342,268,74,2,26,372,162,210,2,-5.25,-14.46,5.09,New England Patriots,2019,Baltimore Ravens
189,Kansas City Chiefs,16,23,17,278,184,94,1,20,346,271,75,2,-5.79,1.14,-1.25,New England Patriots,2019,Kansas City Chiefs
190,Tennessee Titans,13,20,18,307,209,98,2,19,272,71,201,1,-0.84,-2.83,-0.2,New England Patriots,2019,Tennessee Titans
191,Kansas City Chiefs,10,28,19,307,178,129,2,24,467,436,31,1,-2.14,-18.12,2.97,Oakland Raiders,2019,Kansas City Chiefs
192,Indianapolis Colts,31,24,21,377,189,188,1,22,346,265,81,2,8.99,-1.6,0.78,Oakland Raiders,2019,Oakland Raiders
193,Chicago Bears,24,21,25,398,229,169,2,15,236,194,42,2,2.24,3.03,0.43,Oakland Raiders,2019,Oakland Raiders
194,Cincinnati Bengals,17,10,20,386,273,113,2,16,246,73,173,2,3.46,9.64,-3.29,Oakland Raiders,2019,Oakland Raiders
195,New York Jets,3,34,10,208,140,68,2,21,401,313,88,1,-19.86,-12.75,2.36,Oakland Raiders,2019,New York Jets
196,Tennessee Titans,21,42,22,355,258,97,1,26,552,391,161,1,2.19,-29.61,5.43,Oakland Raiders,2019,Tennessee Titans
197,Denver Broncos,15,16,18,477,380,97,1,16,238,168,70,1,-0.3,8.2,-10.2,Oakland Raiders,2019,Denver Broncos
198,Carolina Panthers,30,27,22,349,183,166,1,21,343,216,127,3,4.57,3.24,-3.39,Los Angeles Rams,2019,Los Angeles Rams
199,New Orleans Saints,27,9,20,380,265,115,1,15,244,187,57,1,7.63,13.12,-6.34,Los Angeles Rams,2019,Los Angeles Rams
200,Cleveland Browns,20,13,20,344,254,90,3,18,270,175,95,1,1.06,8.89,-3.41,Los Angeles Rams,2019,Los Angeles Rams
201,Tampa Bay Buccaneers,40,55,36,518,490,28,4,27,464,376,88,1,4.47,-22.76,4.04,Los Angeles Rams,2019,Tampa Bay Buccaneers
202,Seattle Seahawks,29,30,24,477,395,82,2,25,429,262,167,1,9.94,-12.97,1.58,Los Angeles Rams,2019,Seattle Seahawks
203,San Francisco 49ers,7,20,10,157,48,109,1,22,331,232,99,2,-25.23,3.54,5.01,Los Angeles Rams,2019,San Francisco 49ers
204,Pittsburgh Steelers,12,17,16,306,218,88,4,15,273,231,42,2,-27.02,17.68,4.1,Los Angeles Rams,2019,Pittsburgh Steelers
205,Chicago Bears,17,7,13,283,173,110,2,17,267,193,74,1,-5.69,13.17,5.08,Los Angeles Rams,2019,Los Angeles Rams
206,Seattle Seahawks,28,12,26,455,293,162,2,16,308,202,106,1,13.97,7.74,-4.96,Los Angeles Rams,2019,Los Angeles Rams
207,San Francisco 49ers,31,34,24,395,323,72,1,19,334,215,119,2,3.16,-3.67,-1.84,Los Angeles Rams,2019,San Francisco 49ers
208,Cleveland Browns,25,40,24,395,222,173,3,22,530,337,193,1,4.82,-23.04,3.35,Baltimore Ravens,2019,Cleveland Browns
209,Pittsburgh Steelers,26,23,22,277,139,138,3,18,269,192,77,2,-4.12,1.8,5.32,Baltimore Ravens,2019,Baltimore Ravens
210,Cincinnati Bengals,23,17,26,497,228,269,1,18,250,217,33,1,15.13,-0.57,-4.92,Baltimore Ravens,2019,Baltimore Ravens
211,New England Patriots,37,20,26,372,162,210,2,22,342,268,74,2,14.46,5.25,-5.09,Baltimore Ravens,2019,Baltimore Ravens
212,Cincinnati Bengals,49,13,20,379,243,136,1,21,307,150,157,3,24.79,18.52,-7.48,Baltimore Ravens,2019,Baltimore Ravens
213,San Francisco 49ers,20,17,21,283,105,178,1,15,331,157,174,1,6.4,-6.2,1.2,Baltimore Ravens,2019,Baltimore Ravens
214,Buffalo Bills,24,17,18,257,139,118,1,16,209,105,104,1,-0.75,10.78,-2.47,Baltimore Ravens,2019,Baltimore Ravens
215,Cleveland Browns,31,15,31,481,238,243,1,17,241,184,57,1,21.45,0.38,-4.46,Baltimore Ravens,2019,Baltimore Ravens
216,Pittsburgh Steelers,28,10,19,304,81,223,2,10,168,77,91,2,-4.16,11.07,8.63,Baltimore Ravens,2019,Baltimore Ravens
217,Houston Texans,30,28,25,510,362,148,1,22,414,234,180,1,23.59,-19.6,-0.06,New Orleans Saints,2019,New Orleans Saints
218,Los Angeles Rams,9,27,15,244,187,57,1,20,380,265,115,1,-13.12,-7.63,6.34,New Orleans Saints,2019,Los Angeles Rams
219,Seattle Seahawks,33,27,15,265,177,88,1,26,514,406,108,1,0.89,-8.28,6.88,New Orleans Saints,2019,New Orleans Saints
220,Dallas Cowboys,12,10,18,266,149,117,1,15,257,212,45,3,-1.84,-1.46,0.65,New Orleans Saints,2019,New Orleans Saints
221,Carolina Panthers,34,31,23,418,300,118,1,26,351,230,121,1,15.06,-16.55,5.89,New Orleans Saints,2019,New Orleans Saints
222,San Francisco 49ers,46,48,28,465,349,116,1,25,516,354,162,1,21.97,-27.42,3.51,New Orleans Saints,2019,San Francisco 49ers
223,Minnesota Vikings,20,26,19,324,227,97,2,22,362,226,136,1,1.72,-3.22,-3.43,New Orleans Saints,2019,Minnesota Vikings
224,Cincinnati Bengals,21,20,12,232,160,72,1,22,429,395,34,3,-5.43,-0.16,8.5,Seattle Seahawks,2019,Seattle Seahawks
225,Pittsburgh Steelers,28,26,25,425,274,151,2,17,261,180,81,1,5.07,-0.23,1.28,Seattle Seahawks,2019,Seattle Seahawks
226,New Orleans Saints,27,33,26,514,406,108,1,15,265,177,88,1,8.28,-0.89,-6.88,Seattle Seahawks,2019,New Orleans Saints
227,Los Angeles Rams,30,29,25,429,262,167,1,24,477,395,82,2,12.97,-9.94,-1.58,Seattle Seahawks,2019,Seattle Seahawks
228,Cleveland Browns,32,28,29,454,284,170,1,21,406,249,157,4,15.53,-3.24,-4.92,Seattle Seahawks,2019,Seattle Seahawks
229,Tampa Bay Buccaneers,40,34,31,492,347,145,1,29,418,319,99,1,23.58,-13.19,-6.92,Seattle Seahawks,2019,Seattle Seahawks
230,San Francisco 49ers,27,24,19,336,189,147,4,21,302,215,87,3,-17.69,17.73,4.23,Seattle Seahawks,2019,Seattle Seahawks
231,Philadelphia Eagles,17,9,14,348,174,174,2,23,344,238,106,5,-4.38,17.25,-0.2,Seattle Seahawks,2019,Seattle Seahawks
232,Minnesota Vikings,37,30,24,444,226,218,2,17,354,276,78,3,5.79,-6.46,10.5,Seattle Seahawks,2019,Seattle Seahawks
233,Los Angeles Rams,12,28,16,308,202,106,1,26,455,293,162,2,-7.74,-13.97,4.96,Seattle Seahawks,2019,Los Angeles Rams
234,Carolina Panthers,30,24,21,428,274,154,1,28,414,269,145,3,16.22,-6.32,-3.89,Seattle Seahawks,2019,Seattle Seahawks
235,Seattle Seahawks,26,28,17,261,180,81,1,25,425,274,151,2,0.23,-5.07,-1.28,Pittsburgh Steelers,2019,Seattle Seahawks
236,San Francisco 49ers,20,24,11,239,160,79,2,26,436,268,168,5,-10.2,3.72,-0.12,Pittsburgh Steelers,2019,San Francisco 49ers
237,Cincinnati Bengals,27,3,20,326,260,66,1,16,175,102,73,2,6.93,16.54,-0.04,Pittsburgh Steelers,2019,Pittsburgh Steelers
238,Baltimore Ravens,23,26,18,269,192,77,2,22,277,139,138,3,-1.8,4.12,-5.32,Pittsburgh Steelers,2019,Baltimore Ravens
239,Los Angeles Chargers,24,17,18,256,132,124,1,23,348,316,32,3,5.45,2.12,4.54,Pittsburgh Steelers,2019,Pittsburgh Steelers
240,Miami Dolphins,27,14,21,394,236,158,1,16,230,170,60,4,5.58,12.16,-3.84,Pittsburgh Steelers,2019,Pittsburgh Steelers
241,Indianapolis Colts,26,24,17,273,183,90,2,22,328,189,139,3,-3.46,0.41,5.69,Pittsburgh Steelers,2019,Pittsburgh Steelers
242,Los Angeles Rams,17,12,15,273,231,42,2,16,306,218,88,4,-17.68,27.02,-4.1,Pittsburgh Steelers,2019,Pittsburgh Steelers
243,Cincinnati Bengals,16,10,16,338,179,159,1,11,244,158,86,2,-4.31,15.56,-2.52,Pittsburgh Steelers,2019,Pittsburgh Steelers
244,Cleveland Browns,20,13,18,323,199,124,1,19,279,173,106,2,2.57,2.6,1.39,Pittsburgh Steelers,2019,Pittsburgh Steelers
245,Arizona Cardinals,23,17,20,275,135,140,2,17,236,165,71,3,5.34,5.35,-2.85,Pittsburgh Steelers,2019,Pittsburgh Steelers
246,Buffalo Bills,10,17,15,229,178,51,5,17,261,131,130,2,-17.22,6.56,3.78,Pittsburgh Steelers,2019,Buffalo Bills
247,New York Jets,10,16,16,260,185,75,2,14,259,174,85,1,-11.79,8.44,-5.1,Pittsburgh Steelers,2019,New York Jets
248,Baltimore Ravens,10,28,10,168,77,91,2,19,304,81,223,2,-11.07,4.16,-8.63,Pittsburgh Steelers,2019,Baltimore Ravens
249,New Orleans Saints,28,30,22,414,234,180,1,25,510,362,148,1,19.6,-23.59,0.06,Houston Texans,2019,New Orleans Saints
250,Los Angeles Chargers,27,20,20,376,337,39,1,22,366,293,73,1,16.39,-6.08,-1.94,Houston Texans,2019,Houston Texans
251,Carolina Panthers,10,16,18,264,128,136,2,19,297,203,94,3,-9.25,5.69,1.44,Houston Texans,2019,Carolina Panthers
252,Atlanta Falcons,53,32,31,592,426,166,1,22,373,316,57,1,40.69,-6.4,-9.43,Houston Texans,2019,Houston Texans
253,Kansas City Chiefs,31,24,35,472,280,192,3,20,309,256,53,2,16.92,-6.1,-1.87,Houston Texans,2019,Houston Texans
254,Indianapolis Colts,23,30,21,391,291,100,2,23,383,321,62,1,1.33,-8.42,-0.23,Houston Texans,2019,Indianapolis Colts
255,Jacksonville Jaguars,26,3,21,410,194,216,1,21,356,282,74,4,8.05,12.02,-0.32,Houston Texans,2019,Houston Texans
256,Denver Broncos,24,38,26,414,280,134,3,22,391,301,90,1,1.1,-18.37,3.75,Houston Texans,2019,Denver Broncos
257,Tennessee Titans,24,21,23,374,234,140,2,24,432,269,163,1,9.03,-9.37,6.55,Houston Texans,2019,Houston Texans
258,Tampa Bay Buccaneers,23,20,15,229,161,68,2,19,435,329,106,5,-13.02,8.4,7.92,Houston Texans,2019,Houston Texans
259,Buffalo Bills,22,19,19,360,219,141,1,24,425,253,172,1,2.61,1.04,-1.38,Houston Texans,2019,Houston Texans
260,Kansas City Chiefs,31,51,23,442,348,94,1,29,434,316,118,1,5.46,-28.73,6.77,Houston Texans,2019,Kansas City Chiefs
261,Denver Broncos,0,16,12,204,165,39,3,11,270,167,103,1,-25.18,10.82,-1.34,Tennessee Titans,2019,Denver Broncos
262,Los Angeles Chargers,23,20,22,403,306,97,1,24,365,326,39,1,10.83,-8.93,0.57,Tennessee Titans,2019,Tennessee Titans
263,Tampa Bay Buccaneers,27,23,16,246,174,72,1,23,389,283,106,4,-2.72,6.92,1.66,Tennessee Titans,2019,Tennessee Titans
264,Carolina Panthers,20,30,24,431,310,121,3,22,370,214,156,1,5.05,-9.15,-4.67,Tennessee Titans,2019,Carolina Panthers
265,Kansas City Chiefs,35,32,19,371,146,225,1,28,530,433,97,1,11.07,-13.98,3.81,Tennessee Titans,2019,Tennessee Titans
266,Jacksonville Jaguars,42,20,21,471,252,219,2,23,369,252,117,1,20.75,-1.2,2.59,Tennessee Titans,2019,Tennessee Titans
267,Indianapolis Colts,31,17,15,292,138,154,2,22,391,309,82,3,-1.94,1.63,12.84,Tennessee Titans,2019,Tennessee Titans
268,Oakland Raiders,42,21,26,552,391,161,1,22,355,258,97,1,29.61,-2.19,-5.43,Tennessee Titans,2019,Tennessee Titans
269,Houston Texans,21,24,24,432,269,163,1,23,374,234,140,2,9.37,-9.03,-6.55,Tennessee Titans,2019,Houston Texans
270,New England Patriots,20,13,19,272,71,201,1,18,307,209,98,2,2.83,0.84,0.2,Tennessee Titans,2019,Tennessee Titans
271,Green Bay Packers,16,21,15,421,223,198,4,20,335,191,144,2,-6.94,7.02,-5.3,Minnesota Vikings,2019,Green Bay Packers
272,New York Giants,28,10,22,490,279,211,1,18,211,147,64,1,16.93,8.73,-0.4,Minnesota Vikings,2019,Minnesota Vikings
273,Philadelphia Eagles,38,20,26,447,325,122,2,19,400,292,108,3,17.04,-2.18,-0.52,Minnesota Vikings,2019,Minnesota Vikings
274,Washington Redskins,19,9,22,434,273,161,1,14,216,131,85,2,6.29,5.06,-2.48,Minnesota Vikings,2019,Minnesota Vikings
275,Denver Broncos,27,23,19,321,284,37,2,20,394,270,124,1,8.51,-4.61,-2.33,Minnesota Vikings,2019,Minnesota Vikings
276,Seattle Seahawks,30,37,17,354,276,78,3,24,444,226,218,2,6.46,-5.79,-10.5,Minnesota Vikings,2019,Seattle Seahawks
277,Los Angeles Chargers,39,10,18,344,207,137,1,17,345,283,62,7,5.27,20.63,-0.79,Minnesota Vikings,2019,Minnesota Vikings
278,Green Bay Packers,10,23,7,139,82,57,1,22,383,199,184,3,-25.86,5.18,6.94,Minnesota Vikings,2019,Green Bay Packers
279,Chicago Bears,19,21,14,300,126,174,3,24,337,179,158,1,2.15,-1.26,1.08,Minnesota Vikings,2019,Chicago Bears
280,New Orleans Saints,26,20,22,362,226,136,1,19,324,227,97,2,3.22,-1.72,3.43,Minnesota Vikings,2019,Minnesota Vikings
281,San Francisco 49ers,10,27,7,147,126,21,2,21,308,122,186,2,-16.91,-0.66,0.78,Minnesota Vikings,2019,San Francisco 49ers
282,Philadelphia Eagles,20,25,25,417,301,116,3,18,267,174,93,1,0.02,-0.66,-3.75,San Francisco 49ers,2020,Philadelphia Eagles
283,New England Patriots,33,6,26,467,270,197,2,17,241,147,94,4,22.44,9.49,-6.55,San Francisco 49ers,2020,San Francisco 49ers
284,New Orleans Saints,13,27,21,281,232,49,4,17,237,123,114,2,-8.03,2.66,-6.47,San Francisco 49ers,2020,New Orleans Saints
285,Los Angeles Rams,23,20,18,345,233,112,3,14,308,182,126,4,-14.81,19.57,-2.68,San Francisco 49ers,2020,San Francisco 49ers
286,Buffalo Bills,24,34,24,402,316,86,2,31,449,368,81,1,6.59,-18.14,-0.36,San Francisco 49ers,2020,Buffalo Bills
287,Washington Football Team,15,23,21,344,236,108,3,12,193,95,98,1,-25.61,19.42,-0.12,San Francisco 49ers,2020,Washington Football Team
288,Arizona Cardinals,20,12,22,398,171,227,1,20,350,230,120,2,9.69,10.15,-10.68,San Francisco 49ers,2020,San Francisco 49ers
289,New York Giants,17,13,18,304,169,135,2,22,295,220,75,2,3.42,-0.28,-3.92,Chicago Bears,2020,Chicago Bears
290,Atlanta Falcons,30,26,24,437,307,130,2,22,371,227,144,1,2.87,-5.82,5.24,Chicago Bears,2020,Chicago Bears
291,Tampa Bay Buccaneers,20,19,18,243,208,35,1,18,339,233,106,1,-0.67,3.3,1.05,Chicago Bears,2020,Chicago Bears
292,Carolina Panthers,23,16,22,261,198,63,1,23,303,191,112,3,1.01,3.15,2.23,Chicago Bears,2020,Chicago Bears
293,Los Angeles Rams,10,24,14,279,230,49,2,24,371,211,160,1,-17.34,-3.2,5.7,Chicago Bears,2020,Los Angeles Rams
294,Minnesota Vikings,13,19,10,149,108,41,2,19,385,286,99,2,-18.69,3.86,8.08,Chicago Bears,2020,Minnesota Vikings
295,Detroit Lions,30,34,26,389,249,140,1,24,460,400,60,1,12.1,-17.66,0.8,Chicago Bears,2020,Detroit Lions
296,Minnesota Vikings,33,27,23,397,198,199,1,26,407,249,158,1,14.23,-11.76,4,Chicago Bears,2020,Chicago Bears
297,Jacksonville Jaguars,41,17,28,391,263,128,1,14,279,203,76,2,20.23,4.85,-2.73,Chicago Bears,2020,Chicago Bears
298,Green Bay Packers,16,35,21,356,248,108,2,17,316,237,79,1,4.91,-22.83,3.56,Chicago Bears,2020,Green Bay Packers
299,Cleveland Browns,30,35,30,353,285,68,1,23,434,219,215,1,11.19,-19.62,1.79,Cincinnati Bengals,2020,Cleveland Browns
300,Jacksonville Jaguars,33,25,28,505,300,205,1,25,429,340,89,1,19.25,-13.22,4.81,Cincinnati Bengals,2020,Cincinnati Bengals
301,Baltimore Ravens,3,27,12,205,135,70,3,17,332,171,161,1,-28.69,-2.28,3.99,Cincinnati Bengals,2020,Baltimore Ravens
302,Indianapolis Colts,27,31,22,398,300,98,1,23,430,371,59,2,12.35,-16,-0.22,Cincinnati Bengals,2020,Indianapolis Colts
303,Cleveland Browns,34,37,31,468,387,81,2,23,398,316,82,1,22.02,-25.11,1.35,Cincinnati Bengals,2020,Cleveland Browns
304,Washington Football Team,9,20,18,272,202,70,2,20,325,161,164,1,-11.45,0.93,0.86,Cincinnati Bengals,2020,Washington Football Team
305,New York Giants,17,19,11,155,115,40,3,19,386,244,142,1,-18.51,2.23,12.92,Cincinnati Bengals,2020,New York Giants
306,Miami Dolphins,7,19,12,196,156,40,2,23,406,296,110,1,-7.2,-5.94,1.67,Cincinnati Bengals,2020,Miami Dolphins
307,Baltimore Ravens,3,38,10,195,48,147,2,24,525,121,404,1,-14.61,-24.61,7.13,Cincinnati Bengals,2020,Baltimore Ravens
308,Pittsburgh Steelers,21,26,23,319,215,104,2,19,410,301,109,2,-6.02,0.36,-3.9,Denver Broncos,2020,Pittsburgh Steelers
309,New England Patriots,18,12,15,299,164,135,2,14,288,171,117,3,-6.67,13.3,-1.59,Denver Broncos,2020,Denver Broncos
310,Kansas City Chiefs,16,43,24,411,234,177,4,17,286,185,101,1,-15.83,-3.75,-6.31,Denver Broncos,2020,Kansas City Chiefs
311,Los Angeles Chargers,31,30,17,351,243,108,1,28,485,275,210,2,8.64,-9.03,1.18,Denver Broncos,2020,Denver Broncos
312,Atlanta Falcons,27,34,23,405,302,103,1,23,363,271,92,1,4.44,-14.27,-0.15,Denver Broncos,2020,Atlanta Falcons
313,Miami Dolphins,20,13,19,459,270,189,2,17,223,167,56,1,9.2,6.76,-4.92,Denver Broncos,2020,Denver Broncos
314,New Orleans Saints,3,31,6,112,12,100,3,19,292,63,229,1,-26.81,-4.99,4.76,Denver Broncos,2020,New Orleans Saints
315,Buffalo Bills,19,48,19,255,115,140,1,29,534,352,182,1,-3.55,-28.8,0.71,Denver Broncos,2020,Buffalo Bills
316,Baltimore Ravens,6,38,20,306,168,138,3,23,381,270,111,1,-8.32,-16.62,-8.64,Cleveland Browns,2020,Baltimore Ravens
317,Cincinnati Bengals,35,30,23,434,219,215,1,30,353,285,68,1,19.62,-11.19,-1.79,Cleveland Browns,2020,Cleveland Browns
318,Indianapolis Colts,32,23,22,385,261,124,2,15,308,240,68,2,9.88,2.46,-4.93,Cleveland Browns,2020,Cleveland Browns
319,Cincinnati Bengals,37,34,23,398,316,82,1,31,468,387,81,2,25.11,-22.02,-1.35,Cleveland Browns,2020,Cleveland Browns
320,Philadelphia Eagles,22,17,17,324,187,137,1,19,315,209,106,3,-4.43,10.55,1.99,Cleveland Browns,2020,Cleveland Browns
321,Tennessee Titans,41,35,26,458,340,118,1,25,431,369,62,3,16.85,-9.59,1.78,Cleveland Browns,2020,Cleveland Browns
322,Kansas City Chiefs,17,22,21,308,196,112,2,24,438,315,123,1,5.1,-19.09,8.48,Cleveland Browns,2020,Kansas City Chiefs
323,Carolina Panthers,31,17,20,339,217,122,2,24,427,340,87,4,7.61,-0.25,4.83,Tampa Bay Buccaneers,2020,Tampa Bay Buccaneers
324,Los Angeles Chargers,38,31,28,484,369,115,1,15,324,278,46,2,12.95,-5.88,0.2,Tampa Bay Buccaneers,2020,Tampa Bay Buccaneers
325,Chicago Bears,19,20,18,339,233,106,1,18,243,208,35,1,-3.3,0.67,-1.05,Tampa Bay Buccaneers,2020,Chicago Bears
326,New York Giants,25,23,23,344,263,81,1,24,357,256,101,2,5.01,-3.57,2.61,Tampa Bay Buccaneers,2020,Tampa Bay Buccaneers
327,New Orleans Saints,3,38,13,194,186,8,3,27,420,282,138,2,-19.57,-13.73,0.26,Tampa Bay Buccaneers,2020,New Orleans Saints
328,Carolina Panthers,46,23,30,544,334,210,1,13,187,122,65,1,27.3,6.81,-11.18,Tampa Bay Buccaneers,2020,Tampa Bay Buccaneers
329,Los Angeles Rams,24,27,20,251,209,42,2,22,413,376,37,2,-1.67,-5.08,2.02,Tampa Bay Buccaneers,2020,Los Angeles Rams
330,Kansas City Chiefs,24,27,20,417,342,75,2,26,543,456,87,1,12.72,-20.42,2.46,Tampa Bay Buccaneers,2020,Kansas City Chiefs
331,Atlanta Falcons,44,27,28,485,391,94,1,25,385,258,127,2,29.28,-10.53,0.43,Tampa Bay Buccaneers,2020,Tampa Bay Buccaneers
332,Washington Football Team,31,23,26,507,365,142,1,23,375,289,86,1,14.51,-5.16,-1.49,Tampa Bay Buccaneers,2020,Tampa Bay Buccaneers
333,Green Bay Packers,31,26,19,351,275,76,3,23,381,314,67,2,14.4,-7.4,0.17,Tampa Bay Buccaneers,2020,Tampa Bay Buccaneers
334,New York Jets,27,17,31,404,306,98,2,15,254,202,52,2,14.47,0.12,-3.63,Buffalo Bills,2020,Buffalo Bills
335,Los Angeles Rams,35,32,23,375,274,101,2,28,478,311,167,2,17.83,-19.86,6.79,Buffalo Bills,2020,Buffalo Bills
336,Kansas City Chiefs,17,26,20,206,122,84,1,27,466,221,245,1,4.19,-21.56,8.48,Buffalo Bills,2020,Kansas City Chiefs
337,New York Jets,18,10,26,422,296,126,1,17,191,91,100,2,6.27,8.08,-3.23,Buffalo Bills,2020,Buffalo Bills
338,New England Patriots,24,21,22,339,149,190,1,20,349,161,188,1,8.85,-8.26,0.85,Buffalo Bills,2020,Buffalo Bills
339,Arizona Cardinals,30,32,22,369,296,73,2,26,453,236,217,2,3.67,-8.17,4.77,Buffalo Bills,2020,Arizona Cardinals
340,Los Angeles Chargers,27,17,23,332,160,172,3,24,367,291,76,1,5.65,-4.93,4.65,Buffalo Bills,2020,Buffalo Bills
341,San Francisco 49ers,34,24,31,449,368,81,1,24,402,316,86,2,18.14,-6.59,0.36,Buffalo Bills,2020,Buffalo Bills
342,Pittsburgh Steelers,26,15,21,334,230,104,2,14,224,177,47,2,3.18,11.72,-0.16,Buffalo Bills,2020,Buffalo Bills
343,Denver Broncos,48,19,29,534,352,182,1,19,255,115,140,1,28.8,3.55,-0.71,Buffalo Bills,2020,Buffalo Bills
344,Miami Dolphins,56,26,24,455,377,78,2,27,454,384,70,4,19.85,8.17,2.88,Buffalo Bills,2020,Buffalo Bills
345,Kansas City Chiefs,24,38,24,363,234,129,1,29,439,325,114,1,3.03,-30.34,9.61,Buffalo Bills,2020,Kansas City Chiefs
346,Washington Football Team,30,15,22,438,278,160,1,19,316,199,117,2,8.92,0.18,6.91,Arizona Cardinals,2020,Arizona Cardinals
347,Carolina Panthers,21,31,21,262,133,129,1,30,444,276,168,1,8.53,-23.36,3.47,Arizona Cardinals,2020,Carolina Panthers
348,Seattle Seahawks,37,34,31,519,360,159,2,33,572,372,200,3,13.97,-11.75,0.78,Arizona Cardinals,2020,Arizona Cardinals
349,Buffalo Bills,32,30,26,453,236,217,2,22,369,296,73,2,8.17,-3.67,-4.77,Arizona Cardinals,2020,Arizona Cardinals
350,New England Patriots,17,20,23,298,160,138,1,16,179,69,110,2,0,4.68,-9.06,Arizona Cardinals,2020,New England Patriots
351,Los Angeles Rams,28,38,18,232,140,92,2,30,463,344,119,1,-0.6,-18.92,6.43,Arizona Cardinals,2020,Los Angeles Rams
352,San Francisco 49ers,12,20,20,350,230,120,2,22,398,171,227,1,-10.15,-9.69,10.68,Arizona Cardinals,2020,San Francisco 49ers
353,Los Angeles Rams,7,18,15,214,166,48,1,21,333,223,110,2,-13.48,6.77,-2.44,Arizona Cardinals,2020,Los Angeles Rams
354,Tampa Bay Buccaneers,31,38,15,324,278,46,2,28,484,369,115,1,5.88,-12.95,-0.2,Los Angeles Chargers,2020,Tampa Bay Buccaneers
355,Denver Broncos,30,31,28,485,275,210,2,17,351,243,108,1,9.03,-8.64,-1.18,Los Angeles Chargers,2020,Denver Broncos
356,Las Vegas Raiders,26,31,26,440,312,128,1,16,320,160,160,1,17.58,-11.13,-10.69,Los Angeles Chargers,2020,Las Vegas Raiders
357,Miami Dolphins,21,29,19,273,174,99,1,17,280,169,111,1,-1.88,7.96,-14.67,Los Angeles Chargers,2020,Miami Dolphins
358,New York Jets,34,28,28,376,347,29,1,20,292,196,96,1,16.66,-7.52,-3.42,Los Angeles Chargers,2020,Los Angeles Chargers
359,Buffalo Bills,17,27,24,367,291,76,1,23,332,160,172,3,4.93,-5.65,-4.65,Los Angeles Chargers,2020,Buffalo Bills
360,Atlanta Falcons,20,17,23,345,240,105,1,19,319,249,70,3,10.14,-5.82,-1.54,Los Angeles Chargers,2020,Los Angeles Chargers
361,Baltimore Ravens,34,20,29,517,385,132,1,16,228,70,158,1,26.62,4.74,-17.39,Kansas City Chiefs,2020,Kansas City Chiefs
362,New England Patriots,26,10,19,323,229,94,1,21,357,172,185,4,5.72,10.82,-3.78,Kansas City Chiefs,2020,Kansas City Chiefs
363,Las Vegas Raiders,32,40,21,413,333,80,1,22,490,346,144,1,10.45,-22.81,0.4,Kansas City Chiefs,2020,Las Vegas Raiders
364,Buffalo Bills,26,17,27,466,221,245,1,20,206,122,84,1,21.56,-4.19,-8.48,Kansas City Chiefs,2020,Kansas City Chiefs
365,Denver Broncos,43,16,17,286,185,101,1,24,411,234,177,4,3.75,15.83,6.31,Kansas City Chiefs,2020,Kansas City Chiefs
366,Las Vegas Raiders,35,31,36,460,352,108,1,25,364,275,89,1,28.52,-19.95,-2.56,Kansas City Chiefs,2020,Kansas City Chiefs
367,Tampa Bay Buccaneers,27,24,26,543,456,87,1,20,417,342,75,2,20.42,-12.72,-2.46,Kansas City Chiefs,2020,Kansas City Chiefs
368,Miami Dolphins,33,27,22,448,354,94,4,27,367,287,80,1,3.61,-10.4,14.14,Kansas City Chiefs,2020,Kansas City Chiefs
369,New Orleans Saints,32,29,34,411,232,179,1,15,285,225,60,1,12.26,-0.3,-8.71,Kansas City Chiefs,2020,Kansas City Chiefs
370,Atlanta Falcons,17,14,23,395,278,117,2,23,367,277,90,1,5.3,-5.95,3.91,Kansas City Chiefs,2020,Kansas City Chiefs
371,Cleveland Browns,22,17,24,438,315,123,1,21,308,196,112,2,19.09,-5.1,-8.48,Kansas City Chiefs,2020,Kansas City Chiefs
372,Buffalo Bills,38,24,29,439,325,114,1,24,363,234,129,1,30.34,-3.03,-9.61,Kansas City Chiefs,2020,Kansas City Chiefs
373,Minnesota Vikings,28,11,24,354,203,151,1,12,175,95,80,3,5.63,9.97,4.52,Indianapolis Colts,2020,Indianapolis Colts
374,Cleveland Browns,23,32,15,308,240,68,2,22,385,261,124,2,-2.46,-9.88,4.93,Indianapolis Colts,2020,Cleveland Browns
375,Cincinnati Bengals,31,27,23,430,371,59,2,22,398,300,98,1,16,-12.35,0.22,Indianapolis Colts,2020,Indianapolis Colts
376,Baltimore Ravens,10,24,20,339,227,112,2,19,266,156,110,1,-13.1,0.58,1.45,Indianapolis Colts,2020,Baltimore Ravens
377,Green Bay Packers,34,31,23,420,280,140,2,21,367,301,66,4,4.31,-6.48,4.3,Indianapolis Colts,2020,Indianapolis Colts
378,Jacksonville Jaguars,28,14,23,437,164,273,1,18,283,230,53,1,14.26,10.79,-8.77,Indianapolis Colts,2020,Indianapolis Colts
379,Seattle Seahawks,31,38,27,522,461,61,3,23,412,295,117,1,9.84,-11.85,-4.6,Dallas Cowboys,2020,Seattle Seahawks
380,New York Giants,37,34,28,402,276,126,2,20,300,211,89,1,11.9,0.61,-7.75,Dallas Cowboys,2020,Dallas Cowboys
381,Philadelphia Eagles,9,23,21,265,132,133,2,18,222,103,119,4,-21.74,11.99,1.73,Dallas Cowboys,2020,Philadelphia Eagles
382,Minnesota Vikings,31,28,24,376,196,180,1,24,430,305,125,2,15.61,-9,-2.73,Dallas Cowboys,2020,Dallas Cowboys
383,Washington Football Team,16,41,13,247,187,60,2,22,338,156,182,1,-17.92,-8.38,-1.4,Dallas Cowboys,2020,Washington Football Team
384,Baltimore Ravens,17,34,29,388,277,111,1,19,401,107,294,1,10.45,-19.5,-3.43,Dallas Cowboys,2020,Baltimore Ravens
385,Philadelphia Eagles,37,17,22,513,362,151,1,24,477,326,151,3,23.4,-5.42,-0.38,Dallas Cowboys,2020,Dallas Cowboys
386,New York Giants,19,23,26,307,199,108,1,22,336,211,125,2,-3.56,-4.34,4.88,Dallas Cowboys,2020,New York Giants
387,New England Patriots,11,21,20,269,182,87,3,29,357,140,217,1,-2.2,-14.11,5.64,Miami Dolphins,2020,New England Patriots
388,Seattle Seahawks,23,31,25,415,312,103,2,26,441,343,98,1,7.12,-16.11,1.32,Miami Dolphins,2020,Seattle Seahawks
389,New York Jets,24,0,18,302,192,110,2,13,263,148,115,1,0.32,18.17,3.79,Miami Dolphins,2020,Miami Dolphins
390,Los Angeles Rams,28,17,8,145,90,55,2,31,471,340,131,4,-21.63,18.41,12.41,Miami Dolphins,2020,Miami Dolphins
391,Los Angeles Chargers,29,21,17,280,169,111,1,19,273,174,99,1,-7.96,1.88,14.67,Miami Dolphins,2020,Miami Dolphins
392,Denver Broncos,13,20,17,223,167,56,1,19,459,270,189,2,-6.76,-9.2,4.92,Miami Dolphins,2020,Denver Broncos
393,New York Jets,20,3,22,345,241,104,2,10,260,173,87,2,1.9,15.02,3.01,Miami Dolphins,2020,Miami Dolphins
394,Cincinnati Bengals,19,7,23,406,296,110,1,12,196,156,40,2,5.94,7.2,-1.67,Miami Dolphins,2020,Miami Dolphins
395,Kansas City Chiefs,27,33,27,367,287,80,1,22,448,354,94,4,10.4,-3.61,-14.14,Miami Dolphins,2020,Kansas City Chiefs
396,New England Patriots,22,12,26,383,133,250,1,18,303,186,117,1,16.71,1,-6.16,Miami Dolphins,2020,Miami Dolphins
397,Buffalo Bills,26,56,27,454,384,70,4,24,455,377,78,2,-8.17,-19.85,-2.88,Miami Dolphins,2020,Buffalo Bills
398,Los Angeles Rams,19,37,25,363,242,121,3,30,449,258,191,1,-0.85,-27.57,8.25,Philadelphia Eagles,2020,Los Angeles Rams
399,San Francisco 49ers,25,20,18,267,174,93,1,25,417,301,116,3,0.66,-0.02,3.75,Philadelphia Eagles,2020,Philadelphia Eagles
400,Pittsburgh Steelers,29,38,20,336,242,94,2,25,367,231,136,1,14.47,-20.16,-3.43,Philadelphia Eagles,2020,Pittsburgh Steelers
401,New York Giants,22,21,27,442,346,96,1,17,325,165,160,3,2.8,1.65,-1.27,Philadelphia Eagles,2020,Philadelphia Eagles
402,Dallas Cowboys,23,9,18,222,103,119,4,21,265,132,133,2,-11.99,21.74,-1.73,Philadelphia Eagles,2020,Philadelphia Eagles
403,Cleveland Browns,17,22,19,315,209,106,3,17,324,187,137,1,-10.55,4.43,-1.99,Philadelphia Eagles,2020,Cleveland Browns
404,New Orleans Saints,24,21,21,413,167,246,1,20,358,262,96,2,6.77,-4.23,1.33,Philadelphia Eagles,2020,Philadelphia Eagles
405,Dallas Cowboys,17,37,24,477,326,151,3,22,513,362,151,1,5.42,-23.4,0.38,Philadelphia Eagles,2020,Dallas Cowboys
406,Washington Football Team,14,20,16,216,98,118,3,16,248,145,103,2,-11.71,8.33,-3.56,Philadelphia Eagles,2020,Washington Football Team
407,Chicago Bears,26,30,22,371,227,144,1,24,437,307,130,2,5.82,-2.87,-5.24,Atlanta Falcons,2020,Chicago Bears
408,Minnesota Vikings,40,23,24,462,363,99,1,19,365,333,32,3,20.17,-0.99,0.84,Atlanta Falcons,2020,Atlanta Falcons
409,Carolina Panthers,25,17,28,401,270,131,1,18,304,157,147,1,15.4,-2.21,-6.84,Atlanta Falcons,2020,Atlanta Falcons
410,Denver Broncos,34,27,23,363,271,92,1,23,405,302,103,1,14.27,-4.44,0.15,Atlanta Falcons,2020,Atlanta Falcons
411,New Orleans Saints,9,24,14,248,196,52,2,24,376,210,166,1,-4.08,-12.49,8.6,Atlanta Falcons,2020,New Orleans Saints
412,Las Vegas Raiders,43,6,23,304,179,125,1,13,243,203,40,5,3.82,34.18,-4.76,Atlanta Falcons,2020,Atlanta Falcons
413,New Orleans Saints,16,21,21,332,262,70,1,23,424,217,207,1,-0.46,-8.37,6.27,Atlanta Falcons,2020,New Orleans Saints
414,Los Angeles Chargers,17,20,19,319,249,70,3,23,345,240,105,1,5.82,-10.14,1.54,Atlanta Falcons,2020,Los Angeles Chargers
415,Kansas City Chiefs,14,17,23,367,277,90,1,23,395,278,117,2,5.95,-5.3,-3.91,Atlanta Falcons,2020,Kansas City Chiefs
416,Tampa Bay Buccaneers,27,44,25,385,258,127,2,28,485,391,94,1,10.53,-29.28,-0.43,Atlanta Falcons,2020,Tampa Bay Buccaneers
417,Pittsburgh Steelers,16,26,20,291,262,29,2,19,349,208,141,1,-6.06,-13.2,5.36,New York Giants,2020,Pittsburgh Steelers
418,Chicago Bears,13,17,22,295,220,75,2,18,304,169,135,2,0.28,-3.42,3.92,New York Giants,2020,Chicago Bears
419,Los Angeles Rams,9,17,19,295,159,136,1,15,240,182,58,1,-8.39,-1.88,3.27,New York Giants,2020,Los Angeles Rams
420,Dallas Cowboys,34,37,20,300,211,89,1,28,402,276,126,2,-0.61,-11.9,7.75,New York Giants,2020,Dallas Cowboys
421,Washington Football Team,20,19,16,240,108,132,1,24,337,251,86,2,4.14,-1.78,2.48,New York Giants,2020,New York Giants
422,Philadelphia Eagles,21,22,17,325,165,160,3,27,442,346,96,1,-1.65,-2.8,1.27,New York Giants,2020,Philadelphia Eagles
423,Tampa Bay Buccaneers,23,25,24,357,256,101,2,23,344,263,81,1,3.57,-5.01,-2.61,New York Giants,2020,Tampa Bay Buccaneers
424,Cincinnati Bengals,19,17,19,386,244,142,1,11,155,115,40,3,-2.23,18.51,-12.92,New York Giants,2020,New York Giants
425,Seattle Seahawks,17,12,13,290,100,190,1,21,327,216,111,2,-3.56,10.03,-2.18,New York Giants,2020,New York Giants
426,Dallas Cowboys,23,19,22,336,211,125,2,26,307,199,108,1,4.34,3.56,-4.88,New York Giants,2020,New York Giants
427,Cincinnati Bengals,25,33,25,429,340,89,1,28,505,300,205,1,13.22,-19.25,-4.81,Jacksonville Jaguars,2020,Cincinnati Bengals
428,Houston Texans,14,30,22,364,289,75,2,24,486,357,129,2,2.21,-18.24,-1.26,Jacksonville Jaguars,2020,Houston Texans
429,Detroit Lions,16,34,16,275,231,44,2,25,403,223,180,1,-3.97,-15.35,-1.46,Jacksonville Jaguars,2020,Detroit Lions
430,Houston Texans,25,27,22,403,288,115,1,19,374,267,107,1,7.61,-9.52,-1.03,Jacksonville Jaguars,2020,Houston Texans
431,Green Bay Packers,20,24,16,260,151,109,1,16,395,315,80,2,-10.89,-1.82,8.95,Jacksonville Jaguars,2020,Green Bay Packers
432,Pittsburgh Steelers,3,27,14,206,133,73,4,23,373,267,106,1,-22.2,-11.97,5.91,Jacksonville Jaguars,2020,Pittsburgh Steelers
433,Minnesota Vikings,24,27,20,390,266,124,4,30,420,275,145,2,-4.24,2.36,-3.19,Jacksonville Jaguars,2020,Minnesota Vikings
434,Tennessee Titans,10,31,20,354,263,91,1,25,454,205,249,1,-3,-16.06,0.34,Jacksonville Jaguars,2020,Tennessee Titans
435,Baltimore Ravens,14,40,17,267,205,62,1,26,409,250,159,1,-1.7,-24.92,0.13,Jacksonville Jaguars,2020,Baltimore Ravens
436,Chicago Bears,17,41,14,279,203,76,2,28,391,263,128,1,-4.85,-20.23,2.73,Jacksonville Jaguars,2020,Chicago Bears
437,Indianapolis Colts,14,28,18,283,230,53,1,23,437,164,273,1,-10.79,-14.26,8.77,Jacksonville Jaguars,2020,Indianapolis Colts
438,Buffalo Bills,17,27,15,254,202,52,2,31,404,306,98,2,-0.12,-14.47,3.63,New York Jets,2020,Buffalo Bills
439,Miami Dolphins,0,24,13,263,148,115,1,18,302,192,110,2,-18.17,-0.32,-3.79,New York Jets,2020,Miami Dolphins
440,Buffalo Bills,10,18,17,191,91,100,2,26,422,296,126,1,-8.08,-6.27,3.23,New York Jets,2020,Buffalo Bills
441,Los Angeles Chargers,28,34,20,292,196,96,1,28,376,347,29,1,7.52,-16.66,3.42,New York Jets,2020,Los Angeles Chargers
442,Miami Dolphins,3,20,10,260,173,87,2,22,345,241,104,2,-15.02,-1.9,-3.01,New York Jets,2020,Miami Dolphins
443,Las Vegas Raiders,28,31,24,376,170,206,3,24,440,368,72,2,7.59,-9.86,0.37,New York Jets,2020,Las Vegas Raiders
444,Seattle Seahawks,3,40,12,185,116,69,1,28,410,236,174,1,-10.41,-22.39,-2.47,New York Jets,2020,Seattle Seahawks
445,New Orleans Saints,29,35,18,281,191,90,1,29,392,228,164,1,11.85,-23.24,5.65,Detroit Lions,2020,New Orleans Saints
446,Jacksonville Jaguars,34,16,25,403,223,180,1,16,275,231,44,2,15.35,3.97,1.46,Detroit Lions,2020,Detroit Lions
447,Carolina Panthers,0,20,10,185,145,40,1,20,374,258,116,2,-18.63,1.61,-3.12,Detroit Lions,2020,Carolina Panthers
448,Houston Texans,25,41,28,388,279,109,3,21,384,307,77,1,-3.34,-11.31,0.56,Detroit Lions,2020,Houston Texans
449,Chicago Bears,34,30,24,460,400,60,1,26,389,249,140,1,17.66,-12.1,-0.8,Detroit Lions,2020,Detroit Lions
450,Jacksonville Jaguars,24,20,16,395,315,80,2,16,260,151,109,1,1.82,10.89,-8.95,Green Bay Packers,2020,Green Bay Packers
451,Indianapolis Colts,31,34,21,367,301,66,4,23,420,280,140,2,6.48,-4.31,-4.3,Green Bay Packers,2020,Indianapolis Colts
452,Tennessee Titans,40,14,27,448,214,234,1,15,260,104,156,2,25.88,3.08,-4.92,Green Bay Packers,2020,Green Bay Packers
453,Chicago Bears,35,16,17,316,237,79,1,21,356,248,108,2,22.83,-4.91,-3.56,Green Bay Packers,2020,Green Bay Packers
454,Tampa Bay Buccaneers,26,31,23,381,314,67,2,19,351,275,76,3,7.4,-14.4,-0.17,Green Bay Packers,2020,Tampa Bay Buccaneers
455,Tampa Bay Buccaneers,17,31,24,427,340,87,4,20,339,217,122,2,0.25,-7.61,-4.83,Carolina Panthers,2020,Tampa Bay Buccaneers
456,Arizona Cardinals,31,21,30,444,276,168,1,21,262,133,129,1,23.36,-8.53,-3.47,Carolina Panthers,2020,Carolina Panthers
457,Chicago Bears,16,23,23,303,191,112,3,22,261,198,63,1,-3.15,-1.01,-2.23,Carolina Panthers,2020,Chicago Bears
458,Atlanta Falcons,17,25,18,304,157,147,1,28,401,270,131,1,2.21,-15.4,6.84,Carolina Panthers,2020,Atlanta Falcons
459,Tampa Bay Buccaneers,23,46,13,187,122,65,1,30,544,334,210,1,-6.81,-27.3,11.18,Carolina Panthers,2020,Tampa Bay Buccaneers
460,Detroit Lions,20,0,20,374,258,116,2,10,185,145,40,1,-1.61,18.63,3.12,Carolina Panthers,2020,Carolina Panthers
461,Minnesota Vikings,27,28,21,374,267,107,1,26,387,291,96,3,7.73,-0.99,-7.86,Carolina Panthers,2020,Minnesota Vikings
462,Washington Football Team,20,13,19,280,167,113,2,20,386,278,108,4,-5.85,5.49,7.24,Carolina Panthers,2020,Carolina Panthers
463,Miami Dolphins,21,11,29,357,140,217,1,20,269,182,87,3,14.11,2.2,-5.64,New England Patriots,2020,New England Patriots
464,Seattle Seahawks,30,35,29,464,397,67,1,22,429,275,154,1,19.82,-14.54,-6.98,New England Patriots,2020,Seattle Seahawks
465,Las Vegas Raiders,36,20,25,406,156,250,1,22,375,249,126,3,11.03,-0.71,5.81,New England Patriots,2020,New England Patriots
466,Kansas City Chiefs,10,26,21,357,172,185,4,19,323,229,94,1,-10.82,-5.72,3.78,New England Patriots,2020,Kansas City Chiefs
467,Denver Broncos,12,18,14,288,171,117,3,15,299,164,135,2,-13.3,6.67,1.59,New England Patriots,2020,Denver Broncos
468,San Francisco 49ers,6,33,17,241,147,94,4,26,467,270,197,2,-9.49,-22.44,6.55,New England Patriots,2020,San Francisco 49ers
469,Buffalo Bills,21,24,20,349,161,188,1,22,339,149,190,1,8.26,-8.85,-0.85,New England Patriots,2020,Buffalo Bills
470,Arizona Cardinals,20,17,16,179,69,110,2,23,298,160,138,1,-4.68,0,9.06,New England Patriots,2020,New England Patriots
471,Los Angeles Rams,3,24,10,220,113,107,1,17,318,132,186,1,-29.77,-1.19,8.58,New England Patriots,2020,Los Angeles Rams
472,Miami Dolphins,12,22,18,303,186,117,1,26,383,133,250,1,-1,-16.71,6.16,New England Patriots,2020,Miami Dolphins
473,New Orleans Saints,34,24,28,377,261,116,1,26,424,312,112,1,22.48,-13.97,-0.31,Oakland Raiders,2020,Oakland Raiders
474,New England Patriots,20,36,22,375,249,126,3,25,406,156,250,1,0.71,-11.03,-5.81,Oakland Raiders,2020,New England Patriots
475,Kansas City Chiefs,40,32,22,490,346,144,1,21,413,333,80,1,22.81,-10.45,-0.4,Oakland Raiders,2020,Oakland Raiders
476,Los Angeles Chargers,31,26,16,320,160,160,1,26,440,312,128,1,11.13,-17.58,10.69,Oakland Raiders,2020,Oakland Raiders
477,Kansas City Chiefs,31,35,25,364,275,89,1,36,460,352,108,1,19.95,-28.52,2.56,Oakland Raiders,2020,Kansas City Chiefs
478,Atlanta Falcons,6,43,13,243,203,40,5,23,304,179,125,1,-34.18,-3.82,4.76,Oakland Raiders,2020,Atlanta Falcons
479,New York Jets,31,28,24,440,368,72,2,24,376,170,206,3,9.86,-7.59,-0.37,Oakland Raiders,2020,Oakland Raiders
480,Philadelphia Eagles,37,19,30,449,258,191,1,25,363,242,121,3,27.57,0.85,-8.25,Los Angeles Rams,2020,Los Angeles Rams
481,Buffalo Bills,32,35,28,478,311,167,2,23,375,274,101,2,19.86,-17.83,-6.79,Los Angeles Rams,2020,Buffalo Bills
482,New York Giants,17,9,15,240,182,58,1,19,295,159,136,1,1.88,8.39,-3.27,Los Angeles Rams,2020,Los Angeles Rams
483,Chicago Bears,24,10,24,371,211,160,1,14,279,230,49,2,3.2,17.34,-5.7,Los Angeles Rams,2020,Los Angeles Rams
484,Miami Dolphins,17,28,31,471,340,131,4,8,145,90,55,2,-18.41,21.63,-12.41,Los Angeles Rams,2020,Miami Dolphins
485,Seattle Seahawks,23,16,24,389,283,106,1,20,333,220,113,3,11.84,3.08,-6.89,Los Angeles Rams,2020,Los Angeles Rams
486,Tampa Bay Buccaneers,27,24,22,413,376,37,2,20,251,209,42,2,5.08,1.67,-2.02,Los Angeles Rams,2020,Los Angeles Rams
487,San Francisco 49ers,20,23,14,308,182,126,4,18,345,233,112,3,-19.57,14.81,2.68,Los Angeles Rams,2020,San Francisco 49ers
488,Arizona Cardinals,38,28,30,463,344,119,1,18,232,140,92,2,18.92,0.6,-6.43,Los Angeles Rams,2020,Los Angeles Rams
489,New England Patriots,24,3,17,318,132,186,1,10,220,113,107,1,1.19,29.77,-8.58,Los Angeles Rams,2020,Los Angeles Rams
490,Arizona Cardinals,18,7,21,333,223,110,2,15,214,166,48,1,-6.77,13.48,2.44,Los Angeles Rams,2020,Los Angeles Rams
491,Cleveland Browns,38,6,23,381,270,111,1,20,306,168,138,3,16.62,8.32,8.64,Baltimore Ravens,2020,Baltimore Ravens
492,Kansas City Chiefs,20,34,16,228,70,158,1,29,517,385,132,1,-4.74,-26.62,17.39,Baltimore Ravens,2020,Kansas City Chiefs
493,Washington Football Team,31,17,18,350,206,144,2,24,343,274,69,1,8.74,-2.58,9.39,Baltimore Ravens,2020,Baltimore Ravens
494,Cincinnati Bengals,27,3,17,332,171,161,1,12,205,135,70,3,2.28,28.69,-3.99,Baltimore Ravens,2020,Baltimore Ravens
495,Pittsburgh Steelers,24,28,25,457,192,265,4,19,221,173,48,1,3.94,-4.67,0.54,Baltimore Ravens,2020,Pittsburgh Steelers
496,Indianapolis Colts,24,10,19,266,156,110,1,20,339,227,112,2,-0.58,13.1,-1.45,Baltimore Ravens,2020,Baltimore Ravens
497,Tennessee Titans,24,30,21,306,177,129,1,26,423,250,173,1,7.48,-13.91,-0.86,Baltimore Ravens,2020,Tennessee Titans
498,Pittsburgh Steelers,14,19,10,219,90,129,2,22,334,266,68,2,-12.11,-2.03,10.71,Baltimore Ravens,2020,Pittsburgh Steelers
499,Dallas Cowboys,34,17,19,401,107,294,1,29,388,277,111,1,19.5,-10.45,3.43,Baltimore Ravens,2020,Baltimore Ravens
500,Jacksonville Jaguars,40,14,26,409,250,159,1,17,267,205,62,1,24.92,1.7,-0.13,Baltimore Ravens,2020,Baltimore Ravens
501,Cincinnati Bengals,38,3,24,525,121,404,1,10,195,48,147,2,24.61,14.61,-7.13,Baltimore Ravens,2020,Baltimore Ravens
502,Tennessee Titans,20,13,22,401,165,236,1,12,209,158,51,1,10.95,2.51,-2.13,Baltimore Ravens,2020,Baltimore Ravens
503,Las Vegas Raiders,24,34,26,424,312,112,1,28,377,261,116,1,13.97,-22.48,0.31,New Orleans Saints,2020,Las Vegas Raiders
504,Detroit Lions,35,29,29,392,228,164,1,18,281,191,90,1,23.24,-11.85,-5.65,New Orleans Saints,2020,New Orleans Saints
505,Tampa Bay Buccaneers,38,3,27,420,282,138,2,13,194,186,8,3,13.73,19.57,-0.26,New Orleans Saints,2020,New Orleans Saints
506,San Francisco 49ers,27,13,17,237,123,114,2,21,281,232,49,4,-2.66,8.03,6.47,New Orleans Saints,2020,New Orleans Saints
507,Atlanta Falcons,24,9,24,376,210,166,1,14,248,196,52,2,12.49,4.08,-8.6,New Orleans Saints,2020,New Orleans Saints
508,Denver Broncos,31,3,19,292,63,229,1,6,112,12,100,3,4.99,26.81,-4.76,New Orleans Saints,2020,New Orleans Saints
509,Atlanta Falcons,21,16,23,424,217,207,1,21,332,262,70,1,8.37,0.46,-6.27,New Orleans Saints,2020,New Orleans Saints
510,Philadelphia Eagles,21,24,20,358,262,96,2,21,413,167,246,1,4.23,-6.77,-1.33,New Orleans Saints,2020,Philadelphia Eagles
511,Kansas City Chiefs,29,32,15,285,225,60,1,34,411,232,179,1,0.3,-12.26,8.71,New Orleans Saints,2020,Kansas City Chiefs
512,New England Patriots,35,30,22,429,275,154,1,29,464,397,67,1,14.54,-19.82,6.98,Seattle Seahawks,2020,Seattle Seahawks
513,Dallas Cowboys,38,31,23,412,295,117,1,27,522,461,61,3,11.85,-9.84,4.6,Seattle Seahawks,2020,Seattle Seahawks
514,Miami Dolphins,31,23,26,441,343,98,1,25,415,312,103,2,16.11,-7.12,-1.32,Seattle Seahawks,2020,Seattle Seahawks
515,Minnesota Vikings,27,26,18,314,190,124,1,31,449,248,201,2,8.96,-6.68,0.07,Seattle Seahawks,2020,Seattle Seahawks
516,Arizona Cardinals,34,37,33,572,372,200,3,31,519,360,159,2,11.75,-13.97,-0.78,Seattle Seahawks,2020,Arizona Cardinals
517,Los Angeles Rams,16,23,20,333,220,113,3,24,389,283,106,1,-3.08,-11.84,6.89,Seattle Seahawks,2020,Los Angeles Rams
518,New York Giants,12,17,21,327,216,111,2,13,290,100,190,1,-10.03,3.56,2.18,Seattle Seahawks,2020,New York Giants
519,New York Jets,40,3,28,410,236,174,1,12,185,116,69,1,22.39,10.41,2.47,Seattle Seahawks,2020,Seattle Seahawks
520,Washington Football Team,20,15,16,302,121,181,1,26,353,269,84,2,3.17,-1.41,4.4,Seattle Seahawks,2020,Seattle Seahawks
521,New York Giants,26,16,19,349,208,141,1,20,291,262,29,2,13.2,6.06,-5.36,Pittsburgh Steelers,2020,Pittsburgh Steelers
522,Denver Broncos,26,21,19,410,301,109,2,23,319,215,104,2,-0.36,6.02,3.9,Pittsburgh Steelers,2020,Pittsburgh Steelers
523,Philadelphia Eagles,38,29,25,367,231,136,1,20,336,242,94,2,20.16,-14.47,3.43,Pittsburgh Steelers,2020,Pittsburgh Steelers
524,Baltimore Ravens,28,24,19,221,173,48,1,25,457,192,265,4,4.67,-3.94,-0.54,Pittsburgh Steelers,2020,Pittsburgh Steelers
525,Jacksonville Jaguars,27,3,23,373,267,106,1,14,206,133,73,4,11.97,22.2,-5.91,Pittsburgh Steelers,2020,Pittsburgh Steelers
526,Baltimore Ravens,19,14,22,334,266,68,2,10,219,90,129,2,2.03,12.11,-10.71,Pittsburgh Steelers,2020,Pittsburgh Steelers
527,Buffalo Bills,15,26,14,224,177,47,2,21,334,230,104,2,-11.72,-3.18,0.16,Pittsburgh Steelers,2020,Buffalo Bills
528,Jacksonville Jaguars,30,14,24,486,357,129,2,22,364,289,75,2,18.24,-2.21,1.26,Houston Texans,2020,Houston Texans
529,Jacksonville Jaguars,27,25,19,374,267,107,1,22,403,288,115,1,9.52,-7.61,1.03,Houston Texans,2020,Houston Texans
530,Detroit Lions,41,25,21,384,307,77,1,28,388,279,109,3,11.31,3.34,-0.56,Houston Texans,2020,Houston Texans
531,Tennessee Titans,38,41,26,457,361,96,1,28,492,204,288,1,17.33,-25.43,4.17,Houston Texans,2020,Tennessee Titans
532,Minnesota Vikings,31,30,23,444,310,134,1,22,464,238,226,3,3.79,-10.21,7.95,Tennessee Titans,2020,Tennessee Titans
533,Baltimore Ravens,30,24,26,423,250,173,1,21,306,177,129,1,13.91,-7.48,0.86,Tennessee Titans,2020,Tennessee Titans
534,Cleveland Browns,35,41,25,431,369,62,3,26,458,340,118,1,9.59,-16.85,-1.78,Tennessee Titans,2020,Cleveland Browns
535,Jacksonville Jaguars,31,10,25,454,205,249,1,20,354,263,91,1,16.06,3,-0.34,Tennessee Titans,2020,Tennessee Titans
536,Green Bay Packers,14,40,15,260,104,156,2,27,448,214,234,1,-3.08,-25.88,4.92,Tennessee Titans,2020,Green Bay Packers
537,Houston Texans,41,38,28,492,204,288,1,26,457,361,96,1,25.43,-17.33,-4.17,Tennessee Titans,2020,Tennessee Titans
538,Baltimore Ravens,13,20,12,209,158,51,1,22,401,165,236,1,-2.51,-10.95,2.13,Tennessee Titans,2020,Baltimore Ravens
539,Indianapolis Colts,11,28,12,175,95,80,3,24,354,203,151,1,-9.97,-5.63,-4.52,Minnesota Vikings,2020,Indianapolis Colts
540,Tennessee Titans,30,31,22,464,238,226,3,23,444,310,134,1,10.21,-3.79,-7.95,Minnesota Vikings,2020,Tennessee Titans
541,Seattle Seahawks,26,27,31,449,248,201,2,18,314,190,124,1,6.68,-8.96,-0.07,Minnesota Vikings,2020,Seattle Seahawks
542,Atlanta Falcons,23,40,19,365,333,32,3,24,462,363,99,1,0.99,-20.17,-0.84,Minnesota Vikings,2020,Atlanta Falcons
543,Chicago Bears,19,13,19,385,286,99,2,10,149,108,41,2,-3.86,18.69,-8.08,Minnesota Vikings,2020,Minnesota Vikings
544,Dallas Cowboys,28,31,24,430,305,125,2,24,376,196,180,1,9,-15.61,2.73,Minnesota Vikings,2020,Dallas Cowboys
545,Carolina Panthers,28,27,26,387,291,96,3,21,374,267,107,1,0.99,-7.73,7.86,Minnesota Vikings,2020,Minnesota Vikings
546,Jacksonville Jaguars,27,24,30,420,275,145,2,20,390,266,124,4,-2.36,4.24,3.19,Minnesota Vikings,2020,Minnesota Vikings
547,Chicago Bears,27,33,26,407,249,158,1,23,397,198,199,1,11.76,-14.23,-4,Minnesota Vikings,2020,Chicago Bears
548,Detroit Lions,41,33,21,442,311,131,2,31,430,314,116,1,15.48,-5.16,-1.73,San Francisco 49ers,2021,San Francisco 49ers
549,Arizona Cardinals,10,17,19,338,186,152,1,20,304,210,94,1,-6.53,-1.74,-0.47,San Francisco 49ers,2021,Arizona Cardinals
550,Indianapolis Colts,18,30,13,280,169,111,4,17,295,147,148,2,-15.3,-1.16,4.24,San Francisco 49ers,2021,Indianapolis Colts
551,Minnesota Vikings,34,26,23,423,215,208,1,17,323,256,67,2,8.93,4.16,-6.1,San Francisco 49ers,2021,San Francisco 49ers
552,Seattle Seahawks,23,30,17,365,294,71,3,21,327,181,146,3,-0.51,-2.27,-3.44,San Francisco 49ers,2021,Seattle Seahawks
553,Atlanta Falcons,31,13,23,397,235,162,1,13,275,213,62,1,20.53,9.41,-11.46,San Francisco 49ers,2021,San Francisco 49ers
554,Houston Texans,23,7,19,416,241,175,1,15,222,136,86,1,5.7,7.88,0.16,San Francisco 49ers,2021,San Francisco 49ers
555,Los Angeles Rams,27,24,23,449,314,135,2,19,265,201,64,2,15.33,-8.42,-3.91,San Francisco 49ers,2021,San Francisco 49ers
556,Dallas Cowboys,23,17,21,341,172,169,1,20,307,230,77,1,2.43,5.37,-5.37,San Francisco 49ers,2021,San Francisco 49ers
557,Green Bay Packers,13,10,12,212,106,106,1,14,263,196,67,1,-11.56,4.75,9.07,San Francisco 49ers,2021,San Francisco 49ers
558,Los Angeles Rams,17,20,16,282,232,50,1,25,396,326,70,1,3.75,-10.05,1.12,San Francisco 49ers,2021,Los Angeles Rams
559,Cincinnati Bengals,20,17,16,206,83,123,1,14,248,179,69,4,-11.15,16.14,-1.51,Chicago Bears,2021,Chicago Bears
560,Detroit Lions,24,14,20,373,185,188,1,23,351,261,90,2,12.01,-1.56,0.02,Chicago Bears,2021,Chicago Bears
561,Tampa Bay Buccaneers,3,38,17,311,168,143,5,28,408,226,182,1,-18.58,-16.41,4.77,Chicago Bears,2021,Tampa Bay Buccaneers
562,Pittsburgh Steelers,27,29,20,414,278,136,2,20,280,175,105,1,4.26,-8.46,4.79,Chicago Bears,2021,Pittsburgh Steelers
563,Baltimore Ravens,13,16,14,353,261,92,1,23,299,176,123,1,0.66,-0.29,-3.41,Chicago Bears,2021,Baltimore Ravens
564,Detroit Lions,16,14,21,378,310,68,1,14,239,163,76,1,4.4,2.01,-4.41,Chicago Bears,2021,Chicago Bears
565,Minnesota Vikings,9,17,24,370,255,115,3,13,193,61,132,1,-7.72,4.65,-5.92,Chicago Bears,2021,Minnesota Vikings
566,New York Giants,29,3,17,249,162,87,2,13,155,-6,161,4,-4.47,28.88,1.13,Chicago Bears,2021,Chicago Bears
567,Chicago Bears,17,20,14,248,179,69,4,16,206,83,123,1,-16.14,11.15,1.51,Cincinnati Bengals,2021,Chicago Bears
568,Pittsburgh Steelers,24,10,12,268,172,96,1,21,342,297,45,2,0.17,8.46,6.09,Cincinnati Bengals,2021,Cincinnati Bengals
569,Green Bay Packers,22,25,18,367,264,103,2,21,466,333,133,1,3.92,-9.92,3.51,Cincinnati Bengals,2021,Green Bay Packers
570,Detroit Lions,34,11,20,398,256,142,1,15,228,192,36,1,16.6,8.89,-0.46,Cincinnati Bengals,2021,Cincinnati Bengals
571,New York Jets,31,34,18,318,277,41,1,32,511,414,97,3,3.26,-8.01,4.33,Cincinnati Bengals,2021,New York Jets
572,Las Vegas Raiders,32,13,23,288,129,159,1,13,278,206,72,2,6.5,6.44,5.53,Cincinnati Bengals,2021,Cincinnati Bengals
573,Pittsburgh Steelers,41,10,25,370,172,198,1,16,301,250,51,3,14.42,15.89,-0.88,Cincinnati Bengals,2021,Cincinnati Bengals
574,Los Angeles Chargers,22,41,21,356,260,96,4,18,363,284,79,3,-12.31,-1.98,-1.02,Cincinnati Bengals,2021,Los Angeles Chargers
575,Tennessee Titans,19,16,17,345,280,65,1,16,353,213,140,3,-1.17,3.15,4.99,Cincinnati Bengals,2021,Cincinnati Bengals
576,Kansas City Chiefs,27,24,21,359,243,116,1,24,375,236,139,2,8.39,-11.28,-0.28,Cincinnati Bengals,2021,Cincinnati Bengals
577,New York Giants,27,13,24,420,255,165,1,19,314,254,60,1,20.31,-3.89,-3.35,Denver Broncos,2021,Denver Broncos
578,New York Jets,26,0,23,343,223,120,1,11,162,119,43,2,4.68,27.58,-1.98,Denver Broncos,2021,Denver Broncos
579,Pittsburgh Steelers,19,27,17,374,268,106,1,19,391,244,147,1,5.37,-11.44,-1.98,Denver Broncos,2021,Pittsburgh Steelers
580,Washington Football Team,17,10,17,273,190,83,1,21,342,230,112,2,5.1,-1.75,2.71,Denver Broncos,2021,Denver Broncos
581,Philadelphia Eagles,13,30,17,308,212,96,1,22,386,170,216,1,-6.62,-8.45,0.91,Denver Broncos,2021,Philadelphia Eagles
582,Los Angeles Chargers,28,13,23,302,155,147,1,20,357,285,72,2,12.16,6.58,1.43,Denver Broncos,2021,Denver Broncos
583,Kansas City Chiefs,9,22,22,404,250,154,3,15,267,178,89,1,-8.21,4.04,-5.89,Denver Broncos,2021,Kansas City Chiefs
584,Houston Texans,31,21,22,355,199,156,2,17,302,220,82,2,8.22,-9.61,8.62,Cleveland Browns,2021,Cleveland Browns
585,Detroit Lions,13,10,22,349,165,184,2,12,245,77,168,2,4.65,4.39,-6.08,Cleveland Browns,2021,Cleveland Browns
586,Baltimore Ravens,10,16,14,262,222,40,2,22,303,155,148,4,-11.16,7.17,-4.29,Cleveland Browns,2021,Baltimore Ravens
587,Baltimore Ravens,24,22,20,290,190,100,1,21,389,271,118,2,2.4,8.51,-5.68,Cleveland Browns,2021,Cleveland Browns
588,Pittsburgh Steelers,14,26,15,232,139,93,2,20,299,109,190,1,-12.27,-0.38,-4.51,Cleveland Browns,2021,Pittsburgh Steelers
589,Dallas Cowboys,31,29,24,431,379,52,4,30,451,391,60,1,9.37,-13.67,7.76,Tampa Bay Buccaneers,2021,Tampa Bay Buccaneers
590,Atlanta Falcons,48,25,21,341,259,82,1,19,348,293,55,3,8.63,15.96,-0.72,Tampa Bay Buccaneers,2021,Tampa Bay Buccaneers
591,Philadelphia Eagles,28,22,27,399,297,102,1,16,213,113,100,1,15.69,-9.52,3.01,Tampa Bay Buccaneers,2021,Tampa Bay Buccaneers
592,Chicago Bears,38,3,28,408,226,182,1,17,311,168,143,5,16.41,18.58,-4.77,Tampa Bay Buccaneers,2021,Tampa Bay Buccaneers
593,Washington Football Team,19,29,14,273,220,53,2,23,320,226,94,1,3.21,-10.01,-0.67,Tampa Bay Buccaneers,2021,Washington Football Team
594,New York Giants,30,10,28,402,308,94,1,15,215,149,66,3,10.1,16.38,-4.13,Tampa Bay Buccaneers,2021,Tampa Bay Buccaneers
595,Indianapolis Colts,38,31,28,359,217,142,2,24,392,285,107,5,16.55,-6.27,-3.35,Tampa Bay Buccaneers,2021,Tampa Bay Buccaneers
596,Atlanta Falcons,30,17,25,425,368,57,1,21,380,259,121,1,17.18,-5.45,-2.61,Tampa Bay Buccaneers,2021,Tampa Bay Buccaneers
597,New York Jets,28,24,26,467,405,62,1,22,374,224,150,1,17.5,-13.43,0.2,Tampa Bay Buccaneers,2021,Tampa Bay Buccaneers
598,Los Angeles Rams,27,30,20,359,308,51,2,24,428,355,73,4,-4.46,6.76,-6.08,Tampa Bay Buccaneers,2021,Los Angeles Rams
599,Miami Dolphins,35,0,21,314,171,143,2,13,216,145,71,3,8.16,24.67,-0.37,Buffalo Bills,2021,Buffalo Bills
600,Houston Texans,40,0,26,450,251,199,1,6,109,61,48,5,14.54,32.68,-6.4,Buffalo Bills,2021,Buffalo Bills
601,Tennessee Titans,31,34,28,417,335,82,1,16,362,216,146,1,13.13,-15.97,-0.79,Buffalo Bills,2021,Tennessee Titans
602,Jacksonville Jaguars,6,9,17,301,229,72,3,16,218,139,79,1,-12.53,8.4,-1.32,Buffalo Bills,2021,Jacksonville Jaguars
603,New York Jets,45,17,26,489,350,139,2,22,366,296,70,5,22.44,5.27,-0.62,Buffalo Bills,2021,Buffalo Bills
604,New Orleans Saints,31,6,21,361,248,113,2,12,190,146,44,1,11.92,15.07,0.25,Buffalo Bills,2021,Buffalo Bills
605,New England Patriots,10,14,16,230,131,99,1,11,241,19,222,1,-7.94,1.79,0.85,Buffalo Bills,2021,New England Patriots
606,Carolina Panthers,31,14,21,312,193,119,1,19,275,124,151,1,9.55,11.11,-1.29,Buffalo Bills,2021,Buffalo Bills
607,Atlanta Falcons,29,15,28,351,118,233,3,18,265,169,96,1,12.95,1.07,-1.41,Buffalo Bills,2021,Buffalo Bills
608,Tennessee Titans,38,13,22,416,280,136,1,17,248,162,86,3,8.83,14.48,1.57,Arizona Cardinals,2021,Arizona Cardinals
609,Jacksonville Jaguars,31,19,23,407,316,91,1,20,361,202,159,4,13.26,7.87,-9.13,Arizona Cardinals,2021,Arizona Cardinals
610,San Francisco 49ers,17,10,20,304,210,94,1,19,338,186,152,1,1.74,6.53,0.47,Arizona Cardinals,2021,Arizona Cardinals
611,Houston Texans,31,5,24,397,225,172,1,8,160,118,42,1,13.37,23.71,-10.47,Arizona Cardinals,2021,Arizona Cardinals
612,Carolina Panthers,10,34,11,169,104,65,2,24,341,175,166,2,-19.35,-2.27,-1.02,Arizona Cardinals,2021,Carolina Panthers
613,Detroit Lions,12,30,23,398,293,105,1,22,338,212,126,1,-3.11,-9.87,-1.31,Arizona Cardinals,2021,Detroit Lions
614,Seattle Seahawks,30,38,20,305,187,118,1,19,431,229,202,2,0.21,-12.83,1.02,Arizona Cardinals,2021,Seattle Seahawks
615,Washington Football Team,20,16,27,424,334,90,2,15,259,133,126,1,9.45,-1.45,-1.24,Los Angeles Chargers,2021,Los Angeles Chargers
616,Dallas Cowboys,17,20,24,408,313,95,2,25,419,221,198,1,5.55,-17.5,-1.81,Los Angeles Chargers,2021,Dallas Cowboys
617,Baltimore Ravens,6,34,14,208,182,26,1,27,327,140,187,2,-13.93,-7.5,-4.48,Los Angeles Chargers,2021,Baltimore Ravens
618,New England Patriots,24,27,17,369,206,163,2,21,352,210,142,1,1.35,1.47,-9.98,Los Angeles Chargers,2021,New England Patriots
619,Minnesota Vikings,20,27,20,253,171,82,1,24,381,278,103,1,3.95,-8.75,-2.56,Los Angeles Chargers,2021,Minnesota Vikings
620,Denver Broncos,13,28,20,357,285,72,2,23,302,155,147,1,-6.58,-12.16,-1.43,Los Angeles Chargers,2021,Denver Broncos
621,Cincinnati Bengals,41,22,18,363,284,79,3,21,356,260,96,4,1.98,12.31,1.02,Los Angeles Chargers,2021,Los Angeles Chargers
622,Kansas City Chiefs,28,34,28,428,236,192,2,26,496,410,86,2,6.23,-13.18,1.57,Los Angeles Chargers,2021,Kansas City Chiefs
623,Baltimore Ravens,35,36,22,405,343,62,2,31,481,230,251,2,15.89,-16.88,1.01,Kansas City Chiefs,2021,Baltimore Ravens
624,Washington Football Team,31,13,29,499,390,109,3,15,276,182,94,2,9.15,5.66,1.44,Kansas City Chiefs,2021,Kansas City Chiefs
625,Tennessee Titans,3,27,22,334,257,77,3,24,369,266,103,1,-7.62,-15.54,-0.06,Kansas City Chiefs,2021,Tennessee Titans
626,New York Giants,20,17,29,368,261,107,2,18,300,228,72,1,2.01,2.3,2.73,Kansas City Chiefs,2021,Kansas City Chiefs
627,Las Vegas Raiders,41,14,29,516,422,94,1,15,299,249,50,2,34.37,1.08,-7.21,Kansas City Chiefs,2021,Kansas City Chiefs
628,Dallas Cowboys,19,9,22,370,244,126,2,16,276,194,82,3,-2.37,15.89,-5.44,Kansas City Chiefs,2021,Kansas City Chiefs
629,Denver Broncos,22,9,15,267,178,89,1,22,404,250,154,3,-4.04,8.21,5.89,Kansas City Chiefs,2021,Kansas City Chiefs
630,Los Angeles Chargers,34,28,26,496,410,86,2,28,428,236,192,2,13.18,-6.23,-1.57,Kansas City Chiefs,2021,Kansas City Chiefs
631,Pittsburgh Steelers,42,21,26,478,372,106,2,19,257,201,56,1,16.09,2.06,-0.99,Kansas City Chiefs,2021,Kansas City Chiefs
632,Cincinnati Bengals,24,27,24,375,236,139,2,21,359,243,116,1,11.28,-8.39,0.28,Kansas City Chiefs,2021,Cincinnati Bengals
633,Seattle Seahawks,16,28,23,336,223,113,1,18,381,241,140,1,3.07,-14.35,0.51,Indianapolis Colts,2021,Seattle Seahawks
634,Los Angeles Rams,24,27,22,354,245,109,2,21,371,270,101,2,1.29,-7.11,3.09,Indianapolis Colts,2021,Los Angeles Rams
635,Miami Dolphins,27,17,20,349,210,139,1,13,203,168,35,2,8.09,1.62,4.01,Indianapolis Colts,2021,Indianapolis Colts
636,Baltimore Ravens,25,31,29,513,390,123,1,30,523,437,86,1,24,-21.15,-6.85,Indianapolis Colts,2021,Baltimore Ravens
637,San Francisco 49ers,30,18,17,295,147,148,2,13,280,169,111,4,1.16,15.3,-4.24,Indianapolis Colts,2021,Indianapolis Colts
638,Tennessee Titans,31,34,24,307,224,83,3,18,340,247,93,2,3.55,-5.81,-0.74,Indianapolis Colts,2021,Tennessee Titans
639,Tampa Bay Buccaneers,31,38,24,392,285,107,5,28,359,217,142,2,6.27,-16.55,3.35,Indianapolis Colts,2021,Tampa Bay Buccaneers
640,Houston Texans,31,0,26,389,151,238,1,9,141,57,84,2,12.97,28.83,-9.16,Indianapolis Colts,2021,Indianapolis Colts
641,New England Patriots,27,17,15,275,49,226,1,20,365,284,81,2,3.63,2.77,4.16,Indianapolis Colts,2021,Indianapolis Colts
642,Tampa Bay Buccaneers,29,31,30,451,391,60,1,24,431,379,52,4,13.67,-9.37,-7.76,Dallas Cowboys,2021,Tampa Bay Buccaneers
643,Los Angeles Chargers,20,17,25,419,221,198,1,24,408,313,95,2,17.5,-5.55,1.81,Dallas Cowboys,2021,Dallas Cowboys
644,Philadelphia Eagles,41,21,27,380,220,160,1,12,367,303,64,2,9.13,11.19,-0.01,Dallas Cowboys,2021,Dallas Cowboys
645,New York Giants,44,20,26,515,314,201,2,20,367,294,73,2,20.79,2.65,2.08,Dallas Cowboys,2021,Dallas Cowboys
646,New England Patriots,35,29,32,567,445,122,2,17,335,215,120,2,9.87,-0.65,-0.9,Dallas Cowboys,2021,Dallas Cowboys
647,Atlanta Falcons,43,3,22,431,317,114,1,11,214,111,103,3,16.18,22.4,1.92,Dallas Cowboys,2021,Dallas Cowboys
648,Kansas City Chiefs,9,19,16,276,194,82,3,22,370,244,126,2,-15.89,2.37,5.44,Dallas Cowboys,2021,Kansas City Chiefs
649,New Orleans Saints,27,17,17,377,231,146,1,17,405,252,153,4,-3.59,9.41,5.15,Dallas Cowboys,2021,Dallas Cowboys
650,Washington Football Team,27,20,19,323,201,122,2,14,224,124,100,4,-12.16,25.49,-2.14,Dallas Cowboys,2021,Dallas Cowboys
651,New York Giants,21,6,23,328,203,125,1,15,302,178,124,4,5.96,14.75,-7.36,Dallas Cowboys,2021,Dallas Cowboys
652,San Francisco 49ers,17,23,20,307,230,77,1,21,341,172,169,1,-5.37,-2.43,5.37,Dallas Cowboys,2021,San Francisco 49ers
653,New England Patriots,17,16,16,259,185,74,1,24,393,268,125,2,-0.74,-5.75,6.05,Miami Dolphins,2021,Miami Dolphins
654,Buffalo Bills,0,35,13,216,145,71,3,21,314,171,143,2,-24.67,-8.16,0.37,Miami Dolphins,2021,Buffalo Bills
655,Indianapolis Colts,17,27,13,203,168,35,2,20,349,210,139,1,-1.62,-8.09,-4.01,Miami Dolphins,2021,Indianapolis Colts
656,Jacksonville Jaguars,20,23,23,431,354,77,1,21,396,312,84,1,6.22,-4.44,-2.72,Miami Dolphins,2021,Jacksonville Jaguars
657,Atlanta Falcons,28,30,27,413,281,132,2,21,397,325,72,2,10.04,-10.55,-0.22,Miami Dolphins,2021,Atlanta Falcons
658,Houston Texans,17,9,22,262,215,47,5,14,272,199,73,4,-8.14,19.43,-4.21,Miami Dolphins,2021,Miami Dolphins
659,New York Jets,24,17,20,388,273,115,1,18,380,278,102,1,13.14,-5.03,0.94,Miami Dolphins,2021,Miami Dolphins
660,Carolina Panthers,33,10,22,315,204,111,1,10,198,134,64,3,1.89,17.24,2.85,Miami Dolphins,2021,Miami Dolphins
661,New York Jets,31,24,23,379,196,183,3,16,228,126,102,1,2.65,6.38,-1.79,Miami Dolphins,2021,Miami Dolphins
662,New Orleans Saints,20,3,16,259,173,86,1,10,164,81,83,2,-3.16,24.8,-3.21,Miami Dolphins,2021,Miami Dolphins
663,Dallas Cowboys,21,41,12,367,303,64,2,27,380,220,160,1,-11.19,-9.13,0.01,Philadelphia Eagles,2021,Dallas Cowboys
664,Carolina Panthers,21,18,15,273,182,91,2,17,267,158,109,3,-15.13,16.27,3.99,Philadelphia Eagles,2021,Philadelphia Eagles
665,Tampa Bay Buccaneers,22,28,16,213,113,100,1,27,399,297,102,1,9.52,-15.69,-3.01,Philadelphia Eagles,2021,Tampa Bay Buccaneers
666,Las Vegas Raiders,22,33,22,358,223,135,2,23,442,323,119,1,4.67,-18,-1.38,Philadelphia Eagles,2021,Las Vegas Raiders
667,Denver Broncos,30,13,22,386,170,216,1,17,308,212,96,1,8.45,6.62,-0.91,Philadelphia Eagles,2021,Philadelphia Eagles
668,New Orleans Saints,40,29,21,380,138,242,1,18,323,214,109,3,0.6,9.01,4.11,Philadelphia Eagles,2021,Philadelphia Eagles
669,Tampa Bay Buccaneers,25,48,19,348,293,55,3,21,341,259,82,1,-15.96,-8.63,0.72,Atlanta Falcons,2021,Tampa Bay Buccaneers
670,New York Giants,17,14,18,296,227,69,1,21,346,246,100,1,2.1,-2.33,3.38,Atlanta Falcons,2021,Atlanta Falcons
671,New York Jets,27,20,28,450,342,108,2,17,230,166,64,1,17.36,-3.2,-4.18,Atlanta Falcons,2021,Atlanta Falcons
672,Miami Dolphins,30,28,21,397,325,72,2,27,413,281,132,2,10.55,-10.04,0.22,Atlanta Falcons,2021,Atlanta Falcons
673,Carolina Panthers,13,19,17,213,131,82,2,21,332,129,203,1,-2.84,-0.86,-4.14,Atlanta Falcons,2021,Carolina Panthers
674,Dallas Cowboys,3,43,11,214,111,103,3,22,431,317,114,1,-22.4,-16.18,-1.92,Atlanta Falcons,2021,Dallas Cowboys
675,New England Patriots,0,25,11,165,125,40,4,20,308,174,134,1,-25.53,0.69,-2.44,Atlanta Falcons,2021,New England Patriots
676,Jacksonville Jaguars,21,14,21,332,183,149,1,20,357,216,141,2,6.47,0.52,1.5,Atlanta Falcons,2021,Atlanta Falcons
677,Tampa Bay Buccaneers,17,30,21,380,259,121,1,25,425,368,57,1,5.45,-17.18,2.61,Atlanta Falcons,2021,Tampa Bay Buccaneers
678,Carolina Panthers,29,21,20,318,190,128,1,21,334,243,91,3,4.15,5.38,1.74,Atlanta Falcons,2021,Atlanta Falcons
679,San Francisco 49ers,13,31,13,275,213,62,1,23,397,235,162,1,-9.41,-20.53,11.46,Atlanta Falcons,2021,San Francisco 49ers
680,Detroit Lions,20,16,14,254,207,47,1,19,338,208,130,1,5.42,-6.56,2.23,Atlanta Falcons,2021,Atlanta Falcons
681,Buffalo Bills,15,29,18,265,169,96,1,28,351,118,233,3,-1.07,-12.95,1.41,Atlanta Falcons,2021,Buffalo Bills
682,Denver Broncos,13,27,19,314,254,60,1,24,420,255,165,1,3.89,-20.31,3.35,New York Giants,2021,Denver Broncos
683,Atlanta Falcons,14,17,21,346,246,100,1,18,296,227,69,1,2.33,-2.1,-3.38,New York Giants,2021,Atlanta Falcons
684,New Orleans Saints,27,21,21,485,402,83,1,21,405,235,170,1,15.58,-9,-1.58,New York Giants,2021,New York Giants
685,Dallas Cowboys,20,44,20,367,294,73,2,26,515,314,201,2,-2.65,-20.79,-2.08,New York Giants,2021,Dallas Cowboys
686,Los Angeles Rams,11,38,21,261,201,60,4,22,365,234,131,2,-19.06,-7.63,0.96,New York Giants,2021,Los Angeles Rams
687,Kansas City Chiefs,17,20,18,300,228,72,1,29,368,261,107,2,-2.3,-2.01,-2.73,New York Giants,2021,Kansas City Chiefs
688,Las Vegas Raiders,23,16,16,247,98,149,1,24,403,286,117,3,0.51,1.72,5.84,New York Giants,2021,New York Giants
689,Tampa Bay Buccaneers,10,30,15,215,149,66,3,28,402,308,94,1,-16.38,-10.1,4.13,New York Giants,2021,Tampa Bay Buccaneers
690,Dallas Cowboys,6,21,15,302,178,124,4,23,328,203,125,1,-14.75,-5.96,7.36,New York Giants,2021,Dallas Cowboys
691,Chicago Bears,3,29,13,155,-6,161,4,17,249,162,87,2,-28.88,4.47,-1.13,New York Giants,2021,Chicago Bears
692,Arizona Cardinals,19,31,20,361,202,159,4,23,407,316,91,1,-7.87,-13.26,9.13,Jacksonville Jaguars,2021,Arizona Cardinals
693,Miami Dolphins,23,20,21,396,312,84,1,23,431,354,77,1,4.44,-6.22,2.72,Jacksonville Jaguars,2021,Jacksonville Jaguars
694,Buffalo Bills,9,6,16,218,139,79,1,17,301,229,72,3,-8.4,12.53,1.32,Jacksonville Jaguars,2021,Jacksonville Jaguars
695,Atlanta Falcons,14,21,20,357,216,141,2,21,332,183,149,1,-0.52,-6.47,-1.5,Jacksonville Jaguars,2021,Atlanta Falcons
696,Carolina Panthers,14,19,16,252,207,45,1,18,381,270,111,1,-10,-1.31,3.49,New York Jets,2021,Carolina Panthers
697,Denver Broncos,0,26,11,162,119,43,2,23,343,223,120,1,-27.58,-4.68,1.98,New York Jets,2021,Denver Broncos
698,Atlanta Falcons,20,27,17,230,166,64,1,28,450,342,108,2,3.2,-17.36,4.18,New York Jets,2021,Atlanta Falcons
699,Cincinnati Bengals,34,31,32,511,414,97,3,18,318,277,41,1,8.01,-3.26,-4.33,New York Jets,2021,New York Jets
700,Buffalo Bills,17,45,22,366,296,70,5,26,489,350,139,2,-5.27,-22.44,0.62,New York Jets,2021,Buffalo Bills
701,Miami Dolphins,17,24,18,380,278,102,1,20,388,273,115,1,5.03,-13.14,-0.94,New York Jets,2021,Miami Dolphins
702,Houston Texans,21,14,18,266,109,157,1,13,202,106,96,1,-2.68,9.28,-1.61,New York Jets,2021,New York Jets
703,Miami Dolphins,24,31,16,228,126,102,1,23,379,196,183,3,-6.38,-2.65,1.79,New York Jets,2021,Miami Dolphins
704,Tampa Bay Buccaneers,24,28,22,374,224,150,1,26,467,405,62,1,13.43,-17.5,-0.2,New York Jets,2021,Tampa Bay Buccaneers
705,San Francisco 49ers,33,41,31,430,314,116,1,21,442,311,131,2,5.16,-15.48,1.73,Detroit Lions,2021,San Francisco 49ers
706,Chicago Bears,14,24,23,351,261,90,2,20,373,185,188,1,1.56,-12.01,-0.02,Detroit Lions,2021,Chicago Bears
707,Minnesota Vikings,17,19,22,288,180,108,2,18,384,264,120,2,-7.67,0.5,4.46,Detroit Lions,2021,Minnesota Vikings
708,Cincinnati Bengals,11,34,15,228,192,36,1,20,398,256,142,1,-8.89,-16.6,0.46,Detroit Lions,2021,Cincinnati Bengals
709,Cleveland Browns,10,13,12,245,77,168,2,22,349,165,184,2,-4.39,-4.65,6.08,Detroit Lions,2021,Cleveland Browns
710,Chicago Bears,14,16,14,239,163,76,1,21,378,310,68,1,-2.01,-4.4,4.41,Detroit Lions,2021,Chicago Bears
711,Minnesota Vikings,29,27,23,372,272,100,2,26,426,326,100,1,5.16,-2.07,1.98,Detroit Lions,2021,Detroit Lions
712,Arizona Cardinals,30,12,22,338,212,126,1,23,398,293,105,1,9.87,3.11,1.31,Detroit Lions,2021,Detroit Lions
713,Atlanta Falcons,16,20,19,338,208,130,1,14,254,207,47,1,6.56,-5.42,-2.23,Detroit Lions,2021,Atlanta Falcons
714,Pittsburgh Steelers,27,17,23,367,236,131,1,17,282,220,62,2,7.14,5.05,-3.23,Green Bay Packers,2021,Green Bay Packers
715,Cincinnati Bengals,25,22,21,466,333,133,1,18,367,264,103,2,9.92,-3.92,-3.51,Green Bay Packers,2021,Green Bay Packers
716,Washington Football Team,24,10,19,304,247,57,1,25,430,235,195,2,8.64,0.39,3.31,Green Bay Packers,2021,Green Bay Packers
717,Seattle Seahawks,17,0,22,393,287,106,1,15,208,133,75,2,8.95,11.44,-5.23,Green Bay Packers,2021,Green Bay Packers
718,Los Angeles Rams,36,28,21,399,307,92,1,15,353,285,68,3,4.66,5.92,-0.69,Green Bay Packers,2021,Green Bay Packers
719,San Francisco 49ers,10,13,14,263,196,67,1,12,212,106,106,1,-4.75,11.56,-9.07,Green Bay Packers,2021,San Francisco 49ers
720,New York Jets,19,14,18,381,270,111,1,16,252,207,45,1,1.31,10,-3.49,Carolina Panthers,2021,Carolina Panthers
721,New Orleans Saints,26,7,28,383,294,89,1,6,128,80,48,2,12.61,21.2,-12.63,Carolina Panthers,2021,Carolina Panthers
722,Philadelphia Eagles,18,21,17,267,158,109,3,15,273,182,91,2,-16.27,15.13,-3.99,Carolina Panthers,2021,Philadelphia Eagles
723,Minnesota Vikings,28,34,20,306,188,118,3,26,571,373,198,1,-9.64,-8.77,12.64,Carolina Panthers,2021,Minnesota Vikings
724,Atlanta Falcons,19,13,21,332,129,203,1,17,213,131,82,2,0.86,2.84,4.14,Carolina Panthers,2021,Carolina Panthers
725,New England Patriots,6,24,13,240,162,78,3,17,273,122,151,2,-26.35,3.56,5.26,Carolina Panthers,2021,New England Patriots
726,Arizona Cardinals,34,10,24,341,175,166,2,11,169,104,65,2,2.27,19.35,1.02,Carolina Panthers,2021,Carolina Panthers
727,Miami Dolphins,10,33,10,198,134,64,3,22,315,204,111,1,-17.24,-1.89,-2.85,Carolina Panthers,2021,Miami Dolphins
728,Atlanta Falcons,21,29,21,334,243,91,3,20,318,190,128,1,-5.38,-4.15,-1.74,Carolina Panthers,2021,Atlanta Falcons
729,Buffalo Bills,14,31,19,275,124,151,1,21,312,193,119,1,-11.11,-9.55,1.29,Carolina Panthers,2021,Buffalo Bills
730,Miami Dolphins,16,17,24,393,268,125,2,16,259,185,74,1,5.75,0.74,-6.05,New England Patriots,2021,Miami Dolphins
731,Houston Texans,25,22,21,352,226,126,2,14,360,293,67,1,6.89,-13.76,8.6,New England Patriots,2021,New England Patriots
732,Dallas Cowboys,29,35,17,335,215,120,2,32,567,445,122,2,0.65,-9.87,0.9,New England Patriots,2021,Dallas Cowboys
733,Los Angeles Chargers,27,24,21,352,210,142,1,17,369,206,163,2,-1.47,-1.35,9.98,New England Patriots,2021,New England Patriots
734,Carolina Panthers,24,6,17,273,122,151,2,13,240,162,78,3,-3.56,26.35,-5.26,New England Patriots,2021,New England Patriots
735,Atlanta Falcons,25,0,20,308,174,134,1,11,165,125,40,4,-0.69,25.53,2.44,New England Patriots,2021,New England Patriots
736,Buffalo Bills,14,10,11,241,19,222,1,16,230,131,99,1,-1.79,7.94,-0.85,New England Patriots,2021,New England Patriots
737,Indianapolis Colts,17,27,20,365,284,81,2,15,275,49,226,1,-2.77,-3.63,-4.16,New England Patriots,2021,Indianapolis Colts
738,Baltimore Ravens,33,27,26,491,409,82,1,20,406,217,189,2,11.58,-3,-2.58,Oakland Raiders,2021,Oakland Raiders
739,Philadelphia Eagles,33,22,23,442,323,119,1,22,358,223,135,2,18,-4.67,1.38,Oakland Raiders,2021,Oakland Raiders
740,New York Giants,16,23,24,403,286,117,3,16,247,98,149,1,-1.72,-0.51,-5.84,Oakland Raiders,2021,New York Giants
741,Kansas City Chiefs,14,41,15,299,249,50,2,29,516,422,94,1,-1.08,-34.37,7.21,Oakland Raiders,2021,Kansas City Chiefs
742,Cincinnati Bengals,13,32,13,278,206,72,2,23,288,129,159,1,-6.44,-6.5,-5.53,Oakland Raiders,2021,Cincinnati Bengals
743,Indianapolis Colts,27,24,21,371,270,101,2,22,354,245,109,2,7.11,-1.29,-3.09,Los Angeles Rams,2021,Los Angeles Rams
744,Seattle Seahawks,26,17,24,476,358,118,1,22,354,262,92,2,13.76,-6.71,-0.05,Los Angeles Rams,2021,Los Angeles Rams
745,New York Giants,38,11,22,365,234,131,2,21,261,201,60,4,7.63,19.06,-0.96,Los Angeles Rams,2021,Los Angeles Rams
746,Tennessee Titans,16,28,22,347,253,94,2,16,194,125,69,1,-11.78,-1.15,-0.53,Los Angeles Rams,2021,Tennessee Titans
747,Green Bay Packers,28,36,15,353,285,68,3,21,399,307,92,1,-5.92,-4.66,0.69,Los Angeles Rams,2021,Green Bay Packers
748,Seattle Seahawks,20,10,20,332,209,123,1,13,214,134,80,1,4.19,8.13,-3.72,Los Angeles Rams,2021,Los Angeles Rams
749,Minnesota Vikings,30,23,22,356,197,159,3,19,361,295,66,1,-0.84,1.81,7.8,Los Angeles Rams,2021,Los Angeles Rams
750,Baltimore Ravens,20,19,20,373,300,73,3,19,327,162,165,2,2.98,-0.4,-2.65,Los Angeles Rams,2021,Los Angeles Rams
751,San Francisco 49ers,24,27,19,265,201,64,2,23,449,314,135,2,8.42,-15.33,3.91,Los Angeles Rams,2021,San Francisco 49ers
752,Tampa Bay Buccaneers,30,27,24,428,355,73,4,20,359,308,51,2,-6.76,4.46,6.08,Los Angeles Rams,2021,Los Angeles Rams
753,San Francisco 49ers,20,17,25,396,326,70,1,16,282,232,50,1,10.05,-3.75,-1.12,Los Angeles Rams,2021,Los Angeles Rams
754,Las Vegas Raiders,27,33,20,406,217,189,2,26,491,409,82,1,3,-11.58,2.58,Baltimore Ravens,2021,Las Vegas Raiders
755,Kansas City Chiefs,36,35,31,481,230,251,2,22,405,343,62,2,16.88,-15.89,-1.01,Baltimore Ravens,2021,Baltimore Ravens
756,Indianapolis Colts,31,25,30,523,437,86,1,29,513,390,123,1,21.15,-24,6.85,Baltimore Ravens,2021,Baltimore Ravens
757,Los Angeles Chargers,34,6,27,327,140,187,2,14,208,182,26,1,7.5,13.93,4.48,Baltimore Ravens,2021,Baltimore Ravens
758,Chicago Bears,16,13,23,299,176,123,1,14,353,261,92,1,0.29,-0.66,3.41,Baltimore Ravens,2021,Baltimore Ravens
759,Cleveland Browns,16,10,22,303,155,148,4,14,262,222,40,2,-7.17,11.16,4.29,Baltimore Ravens,2021,Baltimore Ravens
760,Cleveland Browns,22,24,21,389,271,118,2,20,290,190,100,1,-8.51,-2.4,5.68,Baltimore Ravens,2021,Cleveland Browns
761,Los Angeles Rams,19,20,19,327,162,165,2,20,373,300,73,3,0.4,-2.98,2.65,Baltimore Ravens,2021,Los Angeles Rams
762,Pittsburgh Steelers,13,16,20,381,132,249,3,19,314,235,79,1,-10.97,6.77,1.21,Baltimore Ravens,2021,Pittsburgh Steelers
763,Carolina Panthers,7,26,6,128,80,48,2,28,383,294,89,1,-21.2,-12.61,12.63,New Orleans Saints,2021,Carolina Panthers
764,New York Giants,21,27,21,405,235,170,1,21,485,402,83,1,9,-15.58,1.58,New Orleans Saints,2021,New York Giants
765,Washington Football Team,33,22,18,369,271,98,2,26,373,242,131,2,8.56,7.31,-3.41,New Orleans Saints,2021,New Orleans Saints
766,Philadelphia Eagles,29,40,18,323,214,109,3,21,380,138,242,1,-9.01,-0.6,-4.11,New Orleans Saints,2021,Philadelphia Eagles
767,Buffalo Bills,6,31,12,190,146,44,1,21,361,248,113,2,-15.07,-11.92,-0.25,New Orleans Saints,2021,Buffalo Bills
768,Dallas Cowboys,17,27,17,405,252,153,4,17,377,231,146,1,-9.41,3.59,-5.15,New Orleans Saints,2021,Dallas Cowboys
769,Miami Dolphins,3,20,10,164,81,83,2,16,259,173,86,1,-24.8,3.16,3.21,New Orleans Saints,2021,Miami Dolphins
770,Indianapolis Colts,28,16,18,381,241,140,1,23,336,223,113,1,14.35,-3.07,-0.51,Seattle Seahawks,2021,Seattle Seahawks
771,Los Angeles Rams,17,26,22,354,262,92,2,24,476,358,118,1,6.71,-13.76,0.05,Seattle Seahawks,2021,Los Angeles Rams
772,Pittsburgh Steelers,20,23,18,309,165,144,1,22,345,226,119,1,-3.89,1.52,-1.09,Seattle Seahawks,2021,Pittsburgh Steelers
773,Green Bay Packers,0,17,15,208,133,75,2,22,393,287,106,1,-11.44,-8.95,5.23,Seattle Seahawks,2021,Green Bay Packers
774,Washington Football Team,15,17,10,267,233,34,1,27,371,219,152,1,-2.58,-6.29,2.42,Seattle Seahawks,2021,Washington Football Team
775,San Francisco 49ers,30,23,21,327,181,146,3,17,365,294,71,3,2.27,0.51,3.44,Seattle Seahawks,2021,Seattle Seahawks
776,Los Angeles Rams,10,20,13,214,134,80,1,20,332,209,123,1,-8.13,-4.19,3.72,Seattle Seahawks,2021,Los Angeles Rams
777,Arizona Cardinals,38,30,19,431,229,202,2,20,305,187,118,1,12.83,-0.21,-1.02,Seattle Seahawks,2021,Seattle Seahawks
778,Cincinnati Bengals,10,24,21,342,297,45,2,12,268,172,96,1,-8.46,-0.17,-6.09,Pittsburgh Steelers,2021,Cincinnati Bengals
779,Green Bay Packers,17,27,17,282,220,62,2,23,367,236,131,1,-5.05,-7.14,3.23,Pittsburgh Steelers,2021,Green Bay Packers
780,Denver Broncos,27,19,19,391,244,147,1,17,374,268,106,1,11.44,-5.37,1.98,Pittsburgh Steelers,2021,Pittsburgh Steelers
781,Seattle Seahawks,23,20,22,345,226,119,1,18,309,165,144,1,-1.52,3.89,1.09,Pittsburgh Steelers,2021,Pittsburgh Steelers
782,Chicago Bears,29,27,20,280,175,105,1,20,414,278,136,2,8.46,-4.26,-4.79,Pittsburgh Steelers,2021,Pittsburgh Steelers
783,Cincinnati Bengals,10,41,16,301,250,51,3,25,370,172,198,1,-15.89,-14.42,0.88,Pittsburgh Steelers,2021,Cincinnati Bengals
784,Minnesota Vikings,28,36,22,375,269,106,1,22,458,216,242,2,6.41,-8.68,-1.31,Pittsburgh Steelers,2021,Minnesota Vikings
785,Cleveland Browns,26,14,20,299,109,190,1,15,232,139,93,2,0.38,12.27,4.51,Pittsburgh Steelers,2021,Pittsburgh Steelers
786,Baltimore Ravens,16,13,19,314,235,79,1,20,381,132,249,3,-6.77,10.97,-1.21,Pittsburgh Steelers,2021,Pittsburgh Steelers
787,Kansas City Chiefs,21,42,19,257,201,56,1,26,478,372,106,2,-2.06,-16.09,0.99,Pittsburgh Steelers,2021,Kansas City Chiefs
788,Cleveland Browns,21,31,17,302,220,82,2,22,355,199,156,2,9.61,-8.22,-8.62,Houston Texans,2021,Cleveland Browns
789,Buffalo Bills,0,40,6,109,61,48,5,26,450,251,199,1,-32.68,-14.54,6.4,Houston Texans,2021,Buffalo Bills
790,New England Patriots,22,25,14,360,293,67,1,21,352,226,126,2,13.76,-6.89,-8.6,Houston Texans,2021,New England Patriots
791,Arizona Cardinals,5,31,8,160,118,42,1,24,397,225,172,1,-23.71,-13.37,10.47,Houston Texans,2021,Arizona Cardinals
792,Miami Dolphins,9,17,14,272,199,73,4,22,262,215,47,5,-19.43,8.14,4.21,Houston Texans,2021,Miami Dolphins
793,New York Jets,14,21,13,202,106,96,1,18,266,109,157,1,-9.28,2.68,1.61,Houston Texans,2021,New York Jets
794,Indianapolis Colts,0,31,9,141,57,84,2,26,389,151,238,1,-28.83,-12.97,9.16,Houston Texans,2021,Indianapolis Colts
795,San Francisco 49ers,7,23,15,222,136,86,1,19,416,241,175,1,-7.88,-5.7,-0.16,Houston Texans,2021,San Francisco 49ers
796,Arizona Cardinals,13,38,17,248,162,86,3,22,416,280,136,1,-14.48,-8.83,-1.57,Tennessee Titans,2021,Arizona Cardinals
797,Buffalo Bills,34,31,16,362,216,146,1,28,417,335,82,1,15.97,-13.13,0.79,Tennessee Titans,2021,Tennessee Titans
798,Kansas City Chiefs,27,3,24,369,266,103,1,22,334,257,77,3,15.54,7.62,0.06,Tennessee Titans,2021,Tennessee Titans
799,Indianapolis Colts,34,31,18,340,247,93,2,24,307,224,83,3,5.81,-3.55,0.74,Tennessee Titans,2021,Tennessee Titans
800,Los Angeles Rams,28,16,16,194,125,69,1,22,347,253,94,2,1.15,11.78,0.53,Tennessee Titans,2021,Tennessee Titans
801,Cincinnati Bengals,16,19,16,353,213,140,3,17,345,280,65,1,-3.15,1.17,-4.99,Tennessee Titans,2021,Cincinnati Bengals
802,Detroit Lions,19,17,18,384,264,120,2,22,288,180,108,2,-0.5,7.67,-4.46,Minnesota Vikings,2021,Minnesota Vikings
803,Carolina Panthers,34,28,26,571,373,198,1,20,306,188,118,3,8.77,9.64,-12.64,Minnesota Vikings,2021,Minnesota Vikings
804,Los Angeles Chargers,27,20,24,381,278,103,1,20,253,171,82,1,8.75,-3.95,2.56,Minnesota Vikings,2021,Minnesota Vikings
805,San Francisco 49ers,26,34,17,323,256,67,2,23,423,215,208,1,-4.16,-8.93,6.1,Minnesota Vikings,2021,San Francisco 49ers
806,Detroit Lions,27,29,26,426,326,100,1,23,372,272,100,2,2.07,-5.16,-1.98,Minnesota Vikings,2021,Detroit Lions
807,Pittsburgh Steelers,36,28,22,458,216,242,2,22,375,269,106,1,8.68,-6.41,1.31,Minnesota Vikings,2021,Minnesota Vikings
808,Chicago Bears,17,9,13,193,61,132,1,24,370,255,115,3,-4.65,7.72,5.92,Minnesota Vikings,2021,Minnesota Vikings
809,Los Angeles Rams,23,30,19,361,295,66,1,22,356,197,159,3,-1.81,0.84,-7.8,Minnesota Vikings,2021,Los Angeles Rams
810,Chicago Bears,10,19,17,331,155,176,2,15,204,105,99,1,-11.26,-0.67,0.42,San Francisco 49ers,2022,Chicago Bears
811,Carolina Panthers,37,15,22,397,244,153,1,15,308,244,64,1,16.04,13.22,-7.82,San Francisco 49ers,2022,San Francisco 49ers
812,San Francisco 49ers,19,10,15,204,105,99,1,17,331,155,176,2,0.67,11.26,-0.42,Chicago Bears,2022,Chicago Bears
813,Green Bay Packers,10,27,11,228,48,180,1,26,414,211,203,1,-4.4,-16.87,1.71,Chicago Bears,2022,Green Bay Packers
814,Houston Texans,23,20,17,363,82,281,2,17,329,237,92,2,2.69,1.75,-1.18,Chicago Bears,2022,Chicago Bears
815,New York Giants,12,20,16,304,155,149,3,21,333,71,262,2,-6.69,-9.33,7.79,Chicago Bears,2022,New York Giants
816,Minnesota Vikings,22,29,14,271,193,78,1,29,429,312,117,1,1.82,-21.45,9.74,Chicago Bears,2022,Minnesota Vikings
817,New York Jets,27,12,20,330,261,69,1,19,328,252,76,4,3.99,16.45,-6.98,Cincinnati Bengals,2022,Cincinnati Bengals
818,Baltimore Ravens,17,19,20,291,190,101,1,22,325,170,155,1,3.22,-3.89,-1.19,Cincinnati Bengals,2022,Baltimore Ravens
819,Seattle Seahawks,16,17,20,433,330,103,2,19,253,177,76,1,9.94,-4.1,-6.84,Denver Broncos,2022,Seattle Seahawks
820,Indianapolis Colts,9,12,18,375,250,125,2,19,306,200,106,2,-11.36,14.91,-7.4,Denver Broncos,2022,Indianapolis Colts
821,New York Jets,30,31,29,405,221,184,1,20,402,309,93,1,17.92,-15.19,-5.38,Cleveland Browns,2022,New York Jets
822,Atlanta Falcons,20,23,22,403,226,177,2,19,333,131,202,1,5.25,-5.92,-1.44,Cleveland Browns,2022,Atlanta Falcons
823,Dallas Cowboys,19,3,18,347,195,152,1,12,244,173,71,1,0.55,19.4,-2.24,Tampa Bay Buccaneers,2022,Tampa Bay Buccaneers
824,New Orleans Saints,20,10,13,260,188,72,1,18,308,208,100,5,-9.2,18.41,2.71,Tampa Bay Buccaneers,2022,Tampa Bay Buccaneers
825,Green Bay Packers,12,14,19,285,251,34,2,14,315,248,67,2,-9.14,4.08,0.3,Tampa Bay Buccaneers,2022,Green Bay Packers
826,Kansas City Chiefs,31,41,27,376,373,3,2,27,417,228,189,1,14.15,-17.12,-5.33,Tampa Bay Buccaneers,2022,Kansas City Chiefs
827,Los Angeles Rams,31,10,23,413,292,121,4,19,243,191,52,3,13.89,10.29,-3.96,Buffalo Bills,2022,Buffalo Bills
828,Baltimore Ravens,23,20,22,326,201,125,2,22,296,134,162,2,2.1,2.66,-1.69,Buffalo Bills,2022,Buffalo Bills
829,Pittsburgh Steelers,38,3,21,552,432,120,2,23,364,310,54,2,20.66,9.42,3.54,Buffalo Bills,2022,Buffalo Bills
830,Las Vegas Raiders,29,23,28,413,270,143,1,20,324,244,80,1,12,-4.86,1.75,Arizona Cardinals,2022,Arizona Cardinals
831,Carolina Panthers,26,16,20,338,206,132,1,11,220,180,40,3,-6.14,19.54,-1.9,Arizona Cardinals,2022,Arizona Cardinals
832,Houston Texans,34,24,22,419,338,81,1,16,346,215,131,2,16.95,-3.13,-4.62,Los Angeles Chargers,2022,Los Angeles Chargers
833,Indianapolis Colts,17,20,20,315,257,58,2,19,259,177,82,1,1.78,7.1,-13.31,Kansas City Chiefs,2022,Indianapolis Colts
834,Tampa Bay Buccaneers,41,31,27,417,228,189,1,27,376,373,3,2,17.12,-14.15,5.33,Kansas City Chiefs,2022,Kansas City Chiefs
835,Buffalo Bills,20,24,23,387,319,68,2,26,443,318,125,1,6.45,-11.13,-0.56,Kansas City Chiefs,2022,Buffalo Bills
836,Houston Texans,20,20,33,517,340,177,2,20,299,222,77,1,5.67,2.14,-9.43,Indianapolis Colts,2022,None
837,Kansas City Chiefs,20,17,19,259,177,82,1,20,315,257,58,2,-7.1,-1.78,13.31,Indianapolis Colts,2022,Indianapolis Colts
838,Denver Broncos,12,9,19,306,200,106,2,18,375,250,125,2,-14.91,11.36,7.4,Indianapolis Colts,2022,Indianapolis Colts
839,Tampa Bay Buccaneers,3,19,12,244,173,71,1,18,347,195,152,1,-19.4,-0.55,2.24,Dallas Cowboys,2022,Tampa Bay Buccaneers
840,Minnesota Vikings,24,7,25,486,323,163,1,20,264,202,62,3,14.26,7.86,-7.37,Philadelphia Eagles,2022,Philadelphia Eagles
841,Jacksonville Jaguars,29,21,25,401,191,210,1,13,219,148,71,5,-0.18,11.06,-1.97,Philadelphia Eagles,2022,Philadelphia Eagles
842,New Orleans Saints,26,27,26,416,215,201,2,18,385,234,151,1,7.5,-4.62,0.51,Atlanta Falcons,2022,New Orleans Saints
843,Los Angeles Rams,27,31,17,261,171,90,3,24,337,272,65,3,-3.49,-8.46,8.11,Atlanta Falcons,2022,Los Angeles Rams
844,Seattle Seahawks,27,23,24,386,207,179,2,23,420,308,112,1,20.84,-15.09,1.2,Atlanta Falcons,2022,Atlanta Falcons
845,Cleveland Browns,23,20,19,333,131,202,1,22,403,226,177,2,5.92,-5.25,1.44,Atlanta Falcons,2022,Atlanta Falcons
846,Tennessee Titans,21,20,19,394,156,238,2,19,359,266,93,1,3.72,-5.97,2.44,New York Giants,2022,New York Giants
847,Chicago Bears,20,12,21,333,71,262,2,16,304,155,149,3,9.33,6.69,-7.79,New York Giants,2022,New York Giants
848,Washington Commanders,22,28,24,383,260,123,1,26,390,305,85,3,3.64,-9.54,-0.26,Jacksonville Jaguars,2022,Washington Commanders
849,Philadelphia Eagles,21,29,13,219,148,71,5,25,401,191,210,1,-11.06,0.18,1.97,Jacksonville Jaguars,2022,Philadelphia Eagles
850,Baltimore Ravens,9,24,24,380,297,83,2,13,274,211,63,1,-8.07,-3.65,-5.04,New York Jets,2022,Baltimore Ravens
851,Cleveland Browns,31,30,20,402,309,93,1,29,405,221,184,1,15.19,-17.92,5.38,New York Jets,2022,New York Jets
852,Cincinnati Bengals,12,27,19,328,252,76,4,20,330,261,69,1,-16.45,-3.99,6.98,New York Jets,2022,Cincinnati Bengals
853,Pittsburgh Steelers,24,20,19,348,250,98,2,20,297,178,119,4,-1.46,2.55,2.91,New York Jets,2022,New York Jets
854,Minnesota Vikings,24,28,23,416,277,139,1,30,373,250,123,1,8.25,-11.58,-1.93,Detroit Lions,2022,Minnesota Vikings
855,Seattle Seahawks,45,48,27,520,375,145,2,27,555,320,235,1,22.12,-32.93,3.99,Detroit Lions,2022,Seattle Seahawks
856,New England Patriots,0,29,17,312,211,101,2,22,364,188,176,1,-22.04,-10.08,3.38,Detroit Lions,2022,New England Patriots
857,Chicago Bears,27,10,26,414,211,203,1,11,228,48,180,1,16.87,4.4,-1.71,Green Bay Packers,2022,Green Bay Packers
858,Tampa Bay Buccaneers,14,12,14,315,248,67,2,19,285,251,34,2,-4.08,9.14,-0.3,Green Bay Packers,2022,Green Bay Packers
859,New England Patriots,27,24,24,443,244,199,2,17,271,104,167,1,5.17,2,-2.64,Green Bay Packers,2022,Green Bay Packers
860,Arizona Cardinals,16,26,11,220,180,40,3,20,338,206,132,1,-19.54,6.14,1.9,Carolina Panthers,2022,Arizona Cardinals
861,San Francisco 49ers,15,37,15,308,244,64,1,22,397,244,153,1,-13.22,-16.04,7.82,Carolina Panthers,2022,San Francisco 49ers
862,Pittsburgh Steelers,17,14,18,376,252,124,1,16,243,152,91,2,6.14,3.44,-3.25,New England Patriots,2022,New England Patriots
863,Baltimore Ravens,26,37,22,447,302,145,4,19,394,206,188,2,3.5,-11.67,-3.18,New England Patriots,2022,Baltimore Ravens
864,Green Bay Packers,24,27,17,271,104,167,1,24,443,244,199,2,-2,-5.17,2.64,New England Patriots,2022,Green Bay Packers
865,Detroit Lions,29,0,22,364,188,176,1,17,312,211,101,2,10.08,22.04,-3.38,New England Patriots,2022,New England Patriots
866,Arizona Cardinals,23,29,20,324,244,80,1,28,413,270,143,1,4.86,-12,-1.75,Oakland Raiders,2022,Arizona Cardinals
867,Tennessee Titans,22,24,24,396,300,96,1,19,361,252,109,1,9.09,-9.1,-4.28,Oakland Raiders,2022,Tennessee Titans
868,Buffalo Bills,10,31,19,243,191,52,3,23,413,292,121,4,-10.29,-13.89,3.96,Los Angeles Rams,2022,Buffalo Bills
869,Atlanta Falcons,31,27,24,337,272,65,3,17,261,171,90,3,8.46,3.49,-8.11,Los Angeles Rams,2022,Los Angeles Rams
870,New York Jets,24,9,13,274,211,63,1,24,380,297,83,2,3.65,8.07,5.04,Baltimore Ravens,2022,Baltimore Ravens
871,New England Patriots,37,26,19,394,206,188,2,22,447,302,145,4,11.67,-3.5,3.18,Baltimore Ravens,2022,Baltimore Ravens
872,Buffalo Bills,20,23,22,296,134,162,2,22,326,201,125,2,-2.66,-2.1,1.69,Baltimore Ravens,2022,Buffalo Bills
873,Cincinnati Bengals,19,17,22,325,170,155,1,20,291,190,101,1,3.89,-3.22,1.19,Baltimore Ravens,2022,Baltimore Ravens
874,New York Giants,20,24,23,406,195,211,2,18,238,155,83,1,6,-4.93,-8.06,Baltimore Ravens,2022,New York Giants
875,Atlanta Falcons,27,26,18,385,234,151,1,26,416,215,201,2,4.62,-7.5,-0.51,New Orleans Saints,2022,New Orleans Saints
876,Tampa Bay Buccaneers,10,20,18,308,208,100,5,13,260,188,72,1,-18.41,9.2,-2.71,New Orleans Saints,2022,Tampa Bay Buccaneers
877,Minnesota Vikings,25,28,19,338,227,111,2,23,344,263,81,1,7.36,-6.41,-2.69,New Orleans Saints,2022,Minnesota Vikings
878,Seattle Seahawks,39,32,26,438,203,235,2,15,396,245,151,1,15.05,-4.57,-0.32,New Orleans Saints,2022,New Orleans Saints
879,Denver Broncos,17,16,19,253,177,76,1,20,433,330,103,2,4.1,-9.94,6.84,Seattle Seahawks,2022,Seattle Seahawks
880,Atlanta Falcons,23,27,23,420,308,112,1,24,386,207,179,2,15.09,-20.84,-1.2,Seattle Seahawks,2022,Atlanta Falcons
881,Detroit Lions,48,45,27,555,320,235,1,27,520,375,145,2,32.93,-22.12,-3.99,Seattle Seahawks,2022,Seattle Seahawks
882,New Orleans Saints,32,39,15,396,245,151,1,26,438,203,235,2,4.57,-15.05,0.32,Seattle Seahawks,2022,New Orleans Saints
883,New England Patriots,14,17,16,243,152,91,2,18,376,252,124,1,-3.44,-6.14,3.25,Pittsburgh Steelers,2022,New England Patriots
884,New York Jets,20,24,20,297,178,119,4,19,348,250,98,2,-2.55,1.46,-2.91,Pittsburgh Steelers,2022,New York Jets
885,Buffalo Bills,3,38,23,364,310,54,2,21,552,432,120,2,-9.42,-20.66,-3.54,Pittsburgh Steelers,2022,Buffalo Bills
886,Indianapolis Colts,20,20,20,299,222,77,1,33,517,340,177,2,-2.14,-5.67,9.43,Houston Texans,2022,None
887,Chicago Bears,20,23,17,329,237,92,2,17,363,82,281,2,-1.75,-2.69,1.18,Houston Texans,2022,Chicago Bears
888,Los Angeles Chargers,24,34,16,346,215,131,2,22,419,338,81,1,3.13,-16.95,4.62,Houston Texans,2022,Los Angeles Chargers
889,New York Giants,20,21,19,359,266,93,1,19,394,156,238,2,5.97,-3.72,-2.44,Tennessee Titans,2022,New York Giants
890,Las Vegas Raiders,24,22,19,361,252,109,1,24,396,300,96,1,9.1,-9.09,4.28,Tennessee Titans,2022,Tennessee Titans
891,Philadelphia Eagles,7,24,20,264,202,62,3,25,486,323,163,1,-7.86,-14.26,7.37,Minnesota Vikings,2022,Philadelphia Eagles
892,Detroit Lions,28,24,30,373,250,123,1,23,416,277,139,1,11.58,-8.25,1.93,Minnesota Vikings,2022,Minnesota Vikings
893,New Orleans Saints,28,25,23,344,263,81,1,19,338,227,111,2,6.41,-7.36,2.69,Minnesota Vikings,2022,Minnesota Vikings
894,Chicago Bears,29,22,29,429,312,117,1,14,271,193,78,1,21.45,-1.82,-9.74,Minnesota Vikings,2022,Minnesota Vikings